Id,Label,indegree,outdegree,Degree,closnesscentrality,betweenesscentrality,Authority,Hub,eigencentrality
0,7D85D00B,0,1,1,1,0,0,0,0
1,7A6F6CCC,1,0,1,0,0,0.00006,0,0.013758
2,7DD5B89F,0,3,3,0.355556,0,0,0.001219,0
3,7537A223,0,2,2,1,0,0,0,0
4,7DD2A050,0,4,4,0.344828,0,0,0.006627,0
5,77C7B5E8,0,1,1,1,0,0,0.003126,0
6,5DE2FF98,0,1,1,1,0,0,0.000945,0
7,7E56FCD5,2,2,4,0.75,4,0.000112,0.001428,0.007271
8,800E392E,3,4,7,0.833333,9,0.001636,0.000794,0.016678
9,78B7767F,0,1,1,1,0,0,0,0
10,7E2FBAAE,3,0,3,0,0,0.021035,0,0.019105
11,5E068C5F,0,1,1,1,0,0,0.00531,0
12,768C99F1,0,1,1,0.448276,0,0,0.013735,0
13,7D0172BC,0,1,1,1,0,0,0.00531,0
14,7A35FBC1,1,0,1,0,0,0.000035,0,0.003635
15,59F3B2EE,7,0,7,0,0,0.000731,0,0.129067
16,8140D5D3,1,4,5,0.357143,20,0.000398,0.008101,0.003635
17,7EDC1856,1,0,1,0,0,0,0,0.003635
18,7D453AB6,1,0,1,0,0,0.000007,0,0.005559
19,7F6C369F,0,2,2,0.666667,0,0,0.001459,0
20,761CA984,1,0,1,0,0,0,0,0.009957
21,811FC9DE,0,1,1,0.666667,0,0,0,0
22,7FD232AA,0,1,1,1,0,0,0.000028,0
23,755F61AC,1,3,4,0.30303,58,0.001316,0.00452,0.003635
24,7C3A0E28,4,0,4,0,0,0.024041,0,0.035703
25,80656E61,0,1,1,1,0,0,0.000252,0
26,80E915D0,3,0,3,0,0,0.000191,0,0.064852
27,777374F1,1,1,2,0.387755,0,0.000018,0.000075,0.003635
28,148F0660,0,1,1,0.428571,0,0,0.006056,0
29,7F5358E4,2,0,2,0,0,0.006571,0,0.009195
30,800379FB,0,1,1,0.5,0,0,0,0
31,7D9600B7,0,7,7,0.818182,0,0,0.034486,0
32,7D8D4BA3,1,2,3,1,0,0.000279,0.000049,0.007986
33,7D16C979,0,3,3,0.8,0,0,0.000662,0
34,7F5EEB8E,2,1,3,1,2,0,0.000014,0.007271
35,7FB0AC68,0,1,1,0.666667,0,0,0.000542,0
36,7D64A879,2,0,2,0,0,0.005733,0,0.013042
37,7E4483E2,1,1,2,0.666667,2,0.001467,0.0006,0.003635
38,764D36CF,0,8,8,0.684211,0,0,0.075954,0
39,02A6CAF9,1,4,5,0.75,6,0,0.000077,0.003635
40,5D606A47,0,7,7,1,0,0,0.000328,0
41,7D53BC3D,0,2,2,1,0,0,0.017402,0
42,7D2FFE45,1,0,1,0,0,0.00208,0,0.003635
43,7F15A0D2,0,1,1,1,0,0,0,0
44,76365878,1,0,1,0,0,0.000556,0,0.025479
45,06BB7685,1,0,1,0,0,0.001234,0,0.005559
46,81264627,0,4,4,0.404762,0,0,0.012733,0
47,78962548,0,1,1,0.354839,0,0,0.000252,0
48,7CEC8964,0,10,10,0.335079,0,0,0.0148,0
49,7F6AF193,0,1,1,1,0,0,0,0
50,7B186DEB,1,2,3,0.75,14.333333,0.009279,0.00125,0.023377
51,7812E916,1,1,2,1,0,0,0,0.005559
52,75FD9583,4,0,4,0,0,0.019162,0,0.039551
53,81593BED,2,1,3,0.6,3.333333,0.001778,0.006936,0.007271
54,804E5562,1,6,7,0.6,56,0.001115,0.028918,0.013345
55,7E04162B,0,7,7,0.439252,0,0,0.004709,0
56,5DB5964B,1,0,1,0,0,0,0,0.003635
57,7ED85637,0,2,2,0.444444,0,0,0.003805,0
58,7FA7A45A,5,1,6,1,1.833333,0.01601,0.067616,0.022528
59,80F9F540,1,2,3,1,2,0,0.001688,0.003635
60,77B95777,0,2,2,0.294872,0,0,0,0
61,7FC849D5,0,2,2,0.75,0,0,0.001869,0
62,7B0615FC,1,0,1,0,0,0,0,0.003635
63,8103CF9A,1,1,2,1,0,0.009279,0.000844,0.023377
64,7D62607A,3,6,9,0.424658,68,0.008039,0.089066,0.010906
65,7F1A2460,0,1,1,0.37037,0,0,0.005604,0
66,75EF892D,0,2,2,0.370968,0,0,0.001335,0
67,5AFC62A7,0,4,4,0.313043,0,0,0.007052,0
68,70D9780E,1,0,1,0,0,0,0,0.007483
69,7DF20134,0,4,4,0.5,0,0,0.006669,0
70,7BD5410F,3,2,5,0.538462,28,0.000054,0.002876,0.01283
71,78E1EDFA,0,1,1,1,0,0,0.000693,0
72,587C34AC,11,0,11,0,0,0.046285,0,0.146197
73,7E730A2D,0,4,4,0.56,0,0,0.001512,0
74,0B2C3D7C,0,4,4,0.388889,0,0,0.000953,0
75,6CFAE423,1,2,3,1,2,0,0.00139,0.003635
76,7ECB9AA4,1,1,2,0.666667,0,0.009279,0.000803,0.023377
77,8140D342,0,1,1,1,0,0,0.001382,0
78,810AF06F,0,1,1,0.666667,0,0,0.000527,0
79,7DF83938,0,2,2,0.363636,0,0,0.006003,0
80,7FD52FF8,0,1,1,0.666667,0,0,0.00145,0
81,7D3C9F90,6,3,9,1,21.083333,0.03115,0.007944,0.060559
82,805E033C,9,0,9,0,0,0.000016,0,0.049492
83,79B5AA5B,6,11,17,0.522388,291.5,0.004448,0.028845,0.028087
84,7E3CA34B,4,2,6,0.441176,90,0.000469,0.010357,0.023244
85,8024F21C,0,1,1,1,0,0,0.00531,0
86,7E774B71,1,0,1,0,0,0,0,0.045748
87,7F673A41,0,3,3,0.483871,0,0,0.030176,0
88,8099551B,0,1,1,0.6,0,0,0.006936,0
89,7C63472D,0,3,3,0.5625,0,0,0.068748,0
90,7BFA9B67,1,0,1,0,0,0.000085,0,0.003635
91,8175E641,2,0,2,0,0,0.000018,0,0.010146
92,7F649C8F,1,0,1,0,0,0.001425,0,0.014261
93,79131BE6,5,0,5,0,0,0.003416,0,0.033241
94,7EB285F6,0,1,1,1,0,0,0.000001,0
95,807A40AA,0,2,2,0.555556,0,0,0.078586,0
96,80322D31,2,0,2,0,0,0.001345,0,0.009195
97,7803BEEF,0,3,3,0.368932,0,0,0.006862,0
98,7EE30C24,0,1,1,1,0,0,0,0
99,7B88C91F,0,1,1,1,0,0,0,0
100,7987AB2E,2,6,8,0.647059,18,0.000426,0.009402,0.007271
101,7841DAF9,0,4,4,1,0,0,0.069183,0
102,7CE33DDF,5,1,6,0.306667,73.333333,0.015317,0,0.018177
103,7F26A341,2,2,4,0.307692,20,0.000639,0.005407,0.009195
104,811FA871,0,4,4,0.533333,0,0,0.010813,0
105,8179C901,2,2,4,0.75,3.083333,0.000497,0.005046,0.009195
106,7A058BC3,1,0,1,0,0,0.000325,0,0.003635
107,7F000B1F,4,1,5,1,3,0.00667,0.001384,0.018389
108,7EC5F62D,4,1,5,1,11,0.003563,0.00014,0.033453
109,7ACA3745,1,0,1,0,0,0.00466,0,0.005559
110,817697ED,1,0,1,0,0,0,0,0.003635
111,486EBECB,0,6,6,0.351955,0,0,0.000629,0
112,7F95B18D,1,4,5,0.36,9,0.000235,0.002673,0.007483
113,7BCC48BF,1,0,1,0,0,0.000399,0,0.003635
114,7CEB34A9,0,3,3,0.8,0,0,0.00001,0
115,7ED768EE,0,3,3,0.352941,0,0,0.003753,0
116,5B0321DC,1,0,1,0,0,0.000679,0,0.003635
117,8063B0B6,0,3,3,0.482759,0,0,0.020193,0
118,808BF16C,9,3,12,1,35.5,0.018549,0.010469,0.093455
119,7914B5BB,5,0,5,0,0,0.001235,0,0.020101
120,7744E45D,3,0,3,0,0,0.000327,0,0.010906
121,7FD71310,0,9,9,0.462687,0,0,0.017251,0
122,7DE61337,0,2,2,0.396552,0,0,0.005279,0
123,7F315C93,2,8,10,0.590909,26,0.000001,0.027591,0.007271
124,807A10C7,3,0,3,0,0,0.000691,0,0.014754
125,807D6861,0,4,4,1,0,0,0.000268,0
126,5E518C07,4,0,4,0,0,0.000571,0,0.016465
127,7E3C1D58,0,3,3,0.666667,0,0,0.001579,0
128,799628FA,1,0,1,0,0,0.000755,0,0.006063
129,808D0C5F,3,3,6,0.714286,14,0.001954,0.000048,0.010906
130,7E33E04B,1,1,2,0.448276,0,0.001179,0.013735,0.005559
131,7F3DA408,2,2,4,1,38,0.00171,0.001881,0.019269
132,5DBEEAA9,1,1,2,1,0,0,0,0.003635
133,7DCF4BCD,1,1,2,1,0.5,0.000522,0.005071,0.003635
134,7F16C168,0,3,3,0.8,0,0,0.000157,0
135,7D677AE2,2,0,2,0,0,0.000217,0,0.007271
136,76ECCA92,2,0,2,0,0,0.01665,0,0.022661
137,816B0308,0,2,2,1,0,0,0.000273,0
138,7D6CDF34,7,0,7,0,0,0.007466,0,0.03557
139,7701D69D,2,5,7,0.727273,2.233333,0.000799,0.001046,0.007271
140,8172FD15,7,0,7,0,0,0.002031,0,0.045693
141,7CEC6BCD,1,3,4,0.483871,14.5,0.000341,0.015687,0.003635
142,80772866,1,1,2,1,0.333333,0,0.000025,0.003635
143,802E5E20,0,1,1,1,0,0,0.000693,0
144,7EDD5625,2,6,8,0.55,31,0.000119,0.007729,0.009195
145,7B98AEE6,2,2,4,0.533333,26.333333,0.000476,0.000784,0.015209
146,7F93FA04,4,3,7,0.529412,32.5,0.00002,0.00006,0.014542
147,7CD859A5,1,0,1,0,0,0,0,0.003635
148,805E844C,4,3,7,0.48,143.5,0.015373,0.000299,0.041061
149,80A3A201,0,1,1,1,0,0,0,0
150,80F88E29,1,2,3,0.625,0,0.016102,0.004692,0.019026
151,79501935,0,1,1,1,0,0,0.000439,0
152,7E0A0260,1,1,2,1,1,0.000001,0.000323,0.003635
153,7E8C6546,0,1,1,1,0,0,0,0
154,7EFE28BA,0,1,1,1,0,0,0.000049,0
155,042AD5A4,2,0,2,0,0,0,0,0.007271
156,7D7A842B,1,2,3,0.666667,4,0.000063,0.005256,0.003635
157,7D21CE9F,2,7,9,0.666667,11.75,0.003699,0.027209,0.007271
158,7AFE73BA,1,0,1,0,0,0,0,0.003635
159,75B9D6A1,8,86,94,0.436364,1336.07381,0.005085,0.18894,0.029083
160,77482408,0,2,2,0.27027,0,0,0.002083,0
161,80BD2795,0,1,1,1,0,0,0,0
162,589193AA,3,0,3,0,0,0.003081,0,0.017181
163,80C3450C,0,22,22,0.577465,0,0,0.008633,0
164,760DE124,0,1,1,0.354839,0,0,0.000252,0
165,799CD093,2,0,2,0,0,0.007582,0,0.007271
166,79E5F60B,10,1,11,1,69,0.006357,0,0.133502
167,5A8F9D97,7,6,13,0.5,117.583333,0.00681,0.024485,0.034237
168,7FCFFD3E,1,0,1,0,0,0,0,0.003635
169,7693AF0A,1,0,1,0,0,0.000025,0,0.003635
170,7632F20D,0,1,1,0.6,0,0,0.006936,0
171,5ADB8A1B,1,0,1,0,0,0.000011,0,0.003635
172,5A7142B3,2,1,3,1,2,0.005857,0.00342,0.009195
173,82315D16,0,3,3,0.571429,0,0,0.000568,0
174,60AD2A21,0,1,1,0.6,0,0,0,0
175,7D4BEA14,1,1,2,1,1,0,0.001754,0.003635
176,79C856BA,0,4,4,0.391892,0,0,0.069531,0
177,80F3312C,0,1,1,1,0,0,0,0
178,80942790,2,4,6,0.833333,8,0.000419,0.005988,0.007271
179,7D7BEF25,0,2,2,1,0,0,0.000877,0
180,7DAAA0A1,0,2,2,0.666667,0,0,0.000053,0
181,7DA6642A,5,1,6,1,22.166667,0.016574,0.000312,0.050645
182,78342064,0,2,2,0.454545,0,0,0.000005,0
183,67BBF043,1,0,1,0,0,0.00055,0,0.070153
184,7AEC9F9D,0,3,3,0.666667,0,0,0.000982,0
185,7E5C4FF6,0,3,3,0.571429,0,0,0.000186,0
186,7D49B1C6,1,5,6,0.444444,167,0,0.000083,0.011135
187,80C924A4,3,0,3,0,0,0.006011,0,0.017775
188,80ED458A,0,2,2,0.4375,0,0,0.002192,0
189,7FA6AEC1,1,0,1,0,0,0.000014,0,0.005559
190,7F158EA5,0,1,1,0.571429,0,0,0.001356,0
191,7719779F,4,0,4,0,0,0.001137,0,0.018389
192,7F2A3595,0,3,3,0.484848,0,0,0.030204,0
193,80177FB9,0,1,1,0.32,0,0,0.00004,0
194,80CCBFDE,1,1,2,1,0.25,0.002544,0.002482,0.003635
195,80D4DE86,2,0,2,0,0,0.002382,0,0.015056
196,7F29B7FE,5,0,5,0,0,0.000525,0,0.036498
197,764A1F39,0,4,4,0.75,0,0,0.014228,0
198,0F885325,0,5,5,0.325,0,0,0.000376,0
199,7D40003B,17,0,17,0,0,0.018599,0,0.23417
200,806F4843,0,1,1,1,0,0,0.000441,0
201,7F55B8DD,0,5,5,0.388889,0,0,0.020852,0
202,5C44C77F,48,0,48,0,0,0.202653,0,0.65952
203,77E01870,3,1,4,1,1,0.001592,0.000033,0.010906
204,7B9ADFEC,0,1,1,1,0,0,0.067616,0
205,7F921DA8,1,0,1,0,0,0.001807,0,0.003635
206,80A05F05,2,0,2,0,0,0,0,0.009195
207,75437352,1,0,1,0,0,0.001786,0,0.005559
208,7D1E2CFB,0,3,3,0.29108,0,0,0.000764,0
209,7ED49B3D,2,0,2,0,0,0.001308,0,0.007271
210,7E321D7D,0,1,1,1,0,0,0.000906,0
211,7F564B0B,0,2,2,0.4,0,0,0.010651,0
212,7FB0C652,1,0,1,0,0,0.000016,0,0.003635
213,7A07568C,0,2,2,0.384615,0,0,0.000207,0
214,7CD8E1CB,2,0,2,0,0,0.001228,0,0.039622
215,7F00822F,1,0,1,0,0,0,0,0.007483
216,7D37F974,0,2,2,0.75,0,0,0.000546,0
217,583814C1,3,2,5,1,15,0.006001,0.001393,0.023456
218,7E7C18A2,1,10,11,0.318182,39.25,0.000378,0.005549,0.003635
219,7896AD06,0,1,1,0.352941,0,0,0,0
220,584CCE1E,1,0,1,0,0,0.000078,0,0.005559
221,5DED89B0,0,4,4,0.297376,0,0,0.013016,0
222,7E371718,1,4,5,0.833333,6,0.000008,0.000651,0.005559
223,79C13BF2,0,3,3,0.444444,0,0,0.000023,0
224,037C063D,10,0,10,0,0,0.036471,0,0.070243
225,7D0C9DB4,1,1,2,1,1,0.000571,0.005983,0.003635
226,7F101D94,2,0,2,0,0,0.009536,0,0.019317
227,7FC49A52,0,1,1,1,0,0,0.001101,0
228,7B83AD6C,0,7,7,0.555556,0,0,0.000352,0
229,78707C76,0,4,4,0.319444,0,0,0.017848,0
230,815A98F6,1,0,1,0,0,0,0,0.005559
231,805A1129,1,2,3,0.666667,12,0,0.013525,0.007483
232,7E18F46C,1,2,3,1,2,0,0.005108,0.003635
233,7F8C19E3,1,0,1,0,0,0.000003,0,0.003635
234,7F679794,0,1,1,1,0,0,0,0
235,7E2310A0,0,1,1,1,0,0,0.000063,0
236,08F79975,4,0,4,0,0,0.007986,0,0.038815
237,8117F1E6,1,1,2,1,1,0,0.000006,0.003635
238,5CB1004F,0,1,1,1,0,0,0,0
239,7D3A1ECD,0,1,1,1,0,0,0,0
240,7C04890F,1,1,2,1,0,0,0,0.003635
241,7FD349D4,1,0,1,0,0,0.000004,0,0.003635
242,7A0F5457,1,0,1,0,0,0,0,0.003635
243,7D9029DA,10,0,10,0,0,0.001574,0,0.151944
244,80BF6627,2,3,5,0.8,6,0.000741,0.006814,0.007271
245,7589E91F,1,0,1,0,0,0,0,0.003635
246,79C1446A,1,0,1,0,0,0.000392,0,0.003635
247,7FCC242A,1,12,13,0.583333,94.666667,0.000817,0.104424,0.010501
248,77EA5E8A,1,4,5,0.55,13.5,0.001014,0.000931,0.006063
249,7F185F41,0,1,1,0.5,0,0,0,0
250,7F2673EC,0,1,1,0.666667,0,0,0,0
251,7DE659BC,1,3,4,0.583333,7,0,0.002802,0.003635
252,7FF445E3,3,0,3,0,0,0.000549,0,0.01283
253,79830445,0,3,3,1,0,0,0.005375,0
254,048188E9,0,3,3,0.529412,0,0,0.003245,0
255,7FB808C7,0,8,8,0.416667,0,0,0.01708,0
256,7FB11991,3,2,5,0.75,5,0.000443,0.000819,0.010906
257,7A9A0FC3,3,6,9,0.75,103,0.001636,0.009414,0.034618
258,8041E137,2,0,2,0,0,0.000408,0,0.009698
259,81173B1E,0,1,1,1,0,0,0,0
260,7F69C274,0,1,1,0.555556,0,0,0.003931,0
261,802A1154,2,2,4,1,3,0.000901,0.00191,0.007271
262,0B6CBB68,1,0,1,0,0,0.000007,0,0.007357
263,7C18CD0B,1,0,1,0,0,0.003301,0,0.003635
264,074DA1E0,1,0,1,0,0,0.000104,0,0.003635
265,7DCBB194,1,1,2,0.380952,8,0.000027,0.000001,0.003635
266,7C6C9A67,1,0,1,0,0,0.00121,0,0.003635
267,7D7FBA4F,1,6,7,1,3.5,0.00173,0.040714,0.003635
268,7B27EE99,1,1,2,0.325843,6.833333,0.001815,0.002451,0.003635
269,7F66AE28,0,3,3,0.413793,0,0,0.000052,0
270,7E24FBDE,0,1,1,1,0,0,0.002482,0
271,7F480C1A,1,0,1,0,0,0.000044,0,0.003635
272,79C7D70A,0,2,2,0.625,0,0,0.000994,0
273,70813F20,1,0,1,0,0,0.000755,0,0.038588
274,7FB06306,3,0,3,0,0,0.000331,0,0.010906
275,789CF0A7,1,0,1,0,0,0.000767,0,0.003635
276,0AD65583,1,0,1,0,0,0.000558,0,0.003635
277,7D878EAB,2,3,5,0.414634,20.333333,0.001851,0.013168,0.007271
278,7F144A74,3,10,13,0.62069,46,0.000054,0.019147,0.010906
279,7A4C8898,1,1,2,0.306667,22,0.001782,0,0.003635
280,7BCEB3E9,1,1,2,0.666667,0,0.000133,0.00145,0.003635
281,7F658799,1,2,3,0.75,0,0.000111,0.00066,0.01133
282,7C2F9E9F,1,0,1,0,0,0.000408,0,0.003635
283,6ACE1AD4,2,0,2,0,0,0.000008,0,0.011118
284,7E5FEEB4,1,1,2,1,1,0.000727,0,0.003635
285,81117D40,7,2,9,0.75,43,0.004043,0.007064,0.039921
286,7F4B2549,2,0,2,0,0,0.000969,0,0.011118
287,5E0A9D2C,0,9,9,0.380952,0,0,0.007412,0
288,7F9D1FA4,1,8,9,0.458333,21.333333,0.000836,0.103841,0.003635
289,71B4D0C3,4,0,4,0,0,0.020407,0,0.016465
290,7B1E1327,0,5,5,0.415094,0,0,0.002811,0
291,80A4FDF1,4,0,4,0,0,0.001258,0,0.018389
292,7ECDBD52,20,1,21,1,50,0.073249,0.000177,0.129928
293,67E095CE,14,0,14,0,0,0.001528,0,0.31783
294,7E51DF42,0,4,4,0.529412,0,0,0.021425,0
295,76D08651,0,1,1,1,0,0,0.000381,0
296,6C34EC52,1,0,1,0,0,0.000039,0,0.003635
297,7F306BAA,0,1,1,1,0,0,0,0
298,7F79E888,0,11,11,0.415254,0,0,0.020656,0
299,7C8D68A4,2,0,2,0,0,0.000796,0,0.007271
300,08755AC7,8,1,9,1,39.5,0.009872,0.000253,0.071953
301,7B0EC03E,1,1,2,0.428571,6,0,0.00065,0.003635
302,76EC31F1,1,1,2,0.37037,8,0.003494,0.005604,0.005559
303,8046ACB7,1,0,1,0,0,0,0,0.003635
304,80D9734F,1,1,2,1,0,0.009279,0.000855,0.023377
305,7F31DF82,0,1,1,1,0,0,0.002456,0
306,77CA54AD,3,0,3,0,0,0.023961,0,0.033991
307,7D68C874,0,1,1,0.333333,0,0,0,0
308,7F98B6C0,0,2,2,1,0,0,0.004524,0
309,7D485FA1,1,4,5,0.833333,5,0.006473,0.017976,0.003635
310,7EF6E410,7,0,7,0,0,0.002362,0,0.058903
311,75B7EA53,1,0,1,0,0,0.000435,0,0.005559
312,7F504958,1,2,3,0.75,3,0.000001,0.001449,0.003635
313,7D9D6E2D,2,1,3,0.5,2,0.002331,0,0.009195
314,7F774FED,1,2,3,1,2,0.000836,0.004865,0.003635
315,59FEAD29,0,1,1,1,0,0,0,0
316,764C7E8B,0,3,3,0.387755,0,0,0.069992,0
317,788D08FB,1,0,1,0,0,0.007602,0,0.003635
318,05A8DF54,1,0,1,0,0,0.000228,0,0.006566
319,7EE05E96,0,2,2,0.625,0,0,0.003869,0
320,5DFDB313,0,1,1,0.343284,0,0,0.000998,0
321,5B2CCDD6,2,0,2,0,0,0.011588,0,0.014966
322,7A87904A,2,1,3,1,3.866667,0.004767,0.006272,0.016241
323,5BD8EB7C,39,0,39,0,0,0.036678,0,0.478572
324,7E4800F3,2,1,3,1,2,0.007189,0.000227,0.007271
325,7A879296,1,0,1,0,0,0.000341,0,0.003635
326,7E01EFEF,1,1,2,1,0,0,0,0.003635
327,81676EA3,0,3,3,0.6,0,0,0.005326,0
328,80FDE7CC,0,3,3,1,0,0,0.00004,0
329,7ECD6553,2,1,3,1,0.5,0.010369,0.000039,0.015469
330,05DB292F,2,0,2,0,0,0.000009,0,0.010992
331,75F52689,4,1,5,1,4,0.005813,0.006272,0.016465
332,5CFA4E6C,0,1,1,1,0,0,0.000124,0
333,816634A6,5,2,7,1,38.666667,0.004055,0.000317,0.040526
334,7B475188,0,2,2,0.392405,0,0,0.000026,0
335,7E432CD9,1,0,1,0,0,0,0,0.003635
336,7ED3ED01,2,0,2,0,0,0,0,0.011118
337,7C5AD507,1,0,1,0,0,0.009279,0,0.023377
338,7D00A53B,3,0,3,0,0,0,0,0.013334
339,7E5832DF,0,5,5,0.526316,0,0,0.007543,0
340,7F6CE4C2,0,1,1,1,0,0,0,0
341,7D7C0B1A,1,0,1,0,0,0.000076,0,0.003635
342,76DCF5F8,0,2,2,0.478261,0,0,0.000751,0
343,7A51A0B3,0,1,1,1,0,0,0.000157,0
344,7E4C657C,26,0,26,0,0,0.003656,0,0.17305
345,7F394FB4,2,1,3,1,11,0.001154,0.00531,0.013223
346,75A15F1A,2,7,9,0.366667,7.5,0.004083,0.018595,0.007271
347,802CCEA6,2,2,4,1,4,0.000208,0.000262,0.007271
348,814B2EFF,8,0,8,0,0,0.000065,0,0.055233
349,5EE7F681,0,1,1,0.328358,0,0,0,0
350,7C1FA131,0,1,1,1,0,0,0.001594,0
351,803DF285,5,4,9,0.833333,24.5,0.000338,0.006864,0.022025
352,80D48DBB,3,2,5,0.416667,28.5,0.000381,0.001538,0.010906
353,59DF8840,3,4,7,0.642857,32.833333,0.017737,0.003513,0.036599
354,7E97D81B,0,2,2,0.5,0,0,0.000189,0
355,792A1641,0,1,1,0.302326,0,0,0,0
356,8130A608,0,1,1,0.253846,0,0,0.000002,0
357,75D66233,1,0,1,0,0,0,0,0.003635
358,7B09C60F,3,4,7,0.583333,11.166667,0,0.000556,0.010906
359,71A0D76B,1,0,1,0,0,0.000002,0,0.005559
360,76726FF8,4,0,4,0,0,0.005808,0,0.031533
361,0B5F38DB,1,0,1,0,0,0,0,0.007986
362,7E77EF79,0,10,10,0.373272,0,0,0.029458,0
363,74104389,0,1,1,1,0,0,0,0
364,77AF7F89,0,2,2,0.541667,0,0,0.016828,0
365,7DAF9B01,3,0,3,0,0,0.021852,0,0.014754
366,80AAF4A8,1,0,1,0,0,0.000015,0,0.003635
367,7BBD37B2,9,2,11,0.625,81.916667,0.007627,0.000088,0.059274
368,7D39AC23,8,3,11,0.432432,90,0.01737,0.01225,0.043231
369,78162667,0,4,4,0.461538,0,0,0.004468,0
370,7CF8EAEC,0,1,1,0.666667,0,0,0,0
371,7C6BC181,0,2,2,0.75,0,0,0.003124,0
372,7EA1F126,0,1,1,1,0,0,0.000004,0
373,7FD8C093,4,5,9,0.666667,22.82619,0.019345,0.015126,0.034283
374,78DA3158,1,0,1,0,0,0,0,0.003635
375,7C735655,1,0,1,0,0,0.000081,0,0.003635
376,7E5324A5,0,1,1,1,0,0,0.00531,0
377,7B3B94A5,1,0,1,0,0,0.000736,0,0.003635
378,7BA32AFE,0,1,1,0.466667,0,0,0,0
379,5D727B82,1,0,1,0,0,0.000028,0,0.003635
380,7A035EB0,1,0,1,0,0,0.000014,0,0.005559
381,762645B9,0,2,2,0.6,0,0,0.001806,0
382,75AC5FD7,1,1,2,1,1,0.000248,0.067616,0.003635
383,7D3A85F7,0,3,3,0.357798,0,0,0.001268,0
384,60375234,2,0,2,0,0,0.000047,0,0.013042
385,5D5A833D,12,0,12,0,0,0.003795,0,0.131752
386,7E1C5CC1,3,0,3,0,0,0.001626,0,0.010906
387,80ED91C8,2,0,2,0,0,0.006498,0,0.007271
388,7E9BFE53,0,1,1,0.444444,0,0,0.000037,0
389,7DC78D20,1,0,1,0,0,0.000004,0,0.009407
390,584555F4,0,1,1,1,0,0,0,0
391,7ED62E14,4,0,4,0,0,0.014787,0,0.023651
392,7EBCD8A5,1,12,13,0.531915,17.209524,0.00466,0.125419,0.005559
393,7F5F6C20,5,7,12,0.386792,170.5,0.00317,0.01175,0.020101
394,5D92C528,2,0,2,0,0,0.011992,0,0.057576
395,76733797,3,0,3,0,0,0.000099,0,0.022952
396,8062F61C,6,1,7,1,12,0.021793,0,0.030515
397,7E0BAFF3,1,1,2,1,1,0.001807,0,0.003635
398,814F383D,0,3,3,0.8,0,0,0,0
399,83E86F17,1,0,1,0,0,0.000049,0,0.003635
400,7B077EC3,0,2,2,0.666667,0,0,0.068375,0
401,79B447D0,1,2,3,0.444444,12.333333,0,0.000041,0.005559
402,7E1A1D1D,4,1,5,0.571429,11,0.006953,0.002995,0.016465
403,7D2CFD0E,4,31,35,0.38961,432.17619,0.000309,0.079107,0.014542
404,79369AB5,1,6,7,0.378151,36.5,0.001807,0.009194,0.003635
405,7E36B417,0,1,1,1,0,0,0.000002,0
406,7E506999,0,1,1,0.666667,0,0,0,0
407,796C54E5,2,11,13,0.386667,135.166667,0.002555,0.039102,0.009195
408,5D53424E,0,2,2,0.466667,0,0,0,0
409,7EB78B3B,0,2,2,1,0,0,0.007081,0
410,7ED6915E,1,13,14,0.362832,22,0.000767,0.006778,0.003635
411,7D8F2390,0,1,1,0.38,0,0,0.003888,0
412,80916B17,0,1,1,1,0,0,0,0
413,5CDC4A51,0,1,1,1,0,0,0.000201,0
414,04D9BEDE,0,1,1,0.666667,0,0,0,0
415,01157E24,7,12,19,0.568966,227.088889,0.016752,0.028877,0.029296
416,7E0E9F86,1,3,4,1,2,0.006002,0.069146,0.003635
417,7EBCF8CC,0,2,2,0.75,0,0,0.005046,0
418,7F0787C0,3,0,3,0,0,0.000263,0,0.010906
419,6ECDE0E1,0,5,5,0.5,0,0,0.015496,0
420,7F8EB07D,5,0,5,0,0,0.009303,0,0.023948
421,7E216784,0,2,2,0.666667,0,0,0.000295,0
422,7929C131,5,3,8,0.340426,35.166667,0.010124,0.001613,0.030401
423,01C5665C,0,4,4,1,0,0,0.013794,0
424,813AAEB1,0,3,3,0.6,0,0,0.001841,0
425,7DDB7218,0,2,2,0.75,0,0,0.004879,0
426,7995A103,1,9,10,0.360294,106.5,0.016102,0.031902,0.019026
427,05985573,0,5,5,0.309262,0,0,0.000455,0
428,62414B2A,1,0,1,0,0,0,0,0.005559
429,77C7CD4A,1,0,1,0,0,0.000132,0,0.003635
430,8097B109,0,2,2,1,0,0,0.00025,0
431,80C2A721,0,8,8,0.466667,0,0,0.000209,0
432,76E37BDF,0,1,1,1,0,0,0.067616,0
433,7EFD9A36,6,2,8,0.571429,10.209524,0.031465,0.007806,0.052774
434,7B6AE775,1,0,1,0,0,0,0,0.003635
435,7FF4C506,0,1,1,1,0,0,0,0
436,7D761074,2,0,2,0,0,0.000384,0,0.007271
437,75778E67,1,0,1,0,0,0,0,0.003635
438,7EA69F8F,0,2,2,0.375,0,0,0.000211,0
439,808A9F67,14,0,14,0,0,0.040131,0,0.147242
440,77EDC510,0,1,1,0.6,0,0,0.000011,0
441,7F2D02B7,1,0,1,0,0,0,0,0.003635
442,78C44C9E,1,0,1,0,0,0.000054,0,0.003635
443,7DD69CE7,1,7,8,0.4125,24.5,0.00466,0.012734,0.005559
444,7F4A406D,4,1,5,1,7,0.010222,0.000706,0.022237
445,76A37BA4,1,0,1,0,0,0.000354,0,0.012424
446,70A17255,5,0,5,0,0,0.009663,0,0.040433
447,7F54CA1D,0,1,1,1,0,0,0,0
448,772B9BCF,1,0,1,0,0,0.001051,0,0.01133
449,7E84479E,0,3,3,0.413793,0,0,0.023867,0
450,7FA5F426,4,0,4,0,0,0.002493,0,0.018893
451,7F01F4E7,3,0,3,0,0,0.000149,0,0.066772
452,77631389,0,3,3,0.306836,0,0,0.005188,0
453,81193755,8,6,14,0.588235,334.935714,0.000291,0.00194,0.078647
454,5D4CC1C7,1,0,1,0,0,0.000003,0,0.003635
455,77062A4A,1,2,3,0.435897,17,0.000014,0.005084,0.003635
456,7812C9EC,0,5,5,0.335821,0,0,0.002525,0
457,7EDF6B2B,0,1,1,0.6,0,0,0.006235,0
458,7F438797,5,2,7,1,7.916667,0.018618,0.015619,0.022025
459,7DEA170E,3,0,3,0,0,0.000337,0,0.01283
460,752B9B0A,1,45,46,0.396154,179.730952,0.006449,0.054681,0.003635
461,7FC0FCEE,5,5,10,0.625,48.25,0.006018,0.010704,0.020101
462,8154EE42,0,1,1,1,0,0,0.001736,0
463,58D8F572,0,4,4,0.75,0,0,0.003645,0
464,7F6383E3,0,1,1,0.666667,0,0,0.000874,0
465,5EB0C437,1,0,1,0,0,0,0,0.003635
466,80F515A4,4,6,10,1,2.866667,0.002213,0.006772,0.020313
467,80B47A22,0,7,7,0.511628,0,0,0.008558,0
468,807613B8,1,4,5,1,4.333333,0.000244,0.072465,0.005559
469,7E234094,1,0,1,0,0,0,0,0.003635
470,7B43CBDB,1,0,1,0,0,0.000397,0,0.005559
471,7CE59CE3,0,7,7,0.335484,0,0,0.007313,0
472,80DD3185,2,1,3,1,0.5,0.001753,0.017271,0.011622
473,7D7C2D4E,2,4,6,0.578947,14,0.006619,0.078821,0.007271
474,7A401F84,0,2,2,0.666667,0,0,0.000055,0
475,7F558E8C,2,0,2,0,0,0.016221,0,0.022661
476,092B4360,1,0,1,0,0,0.000028,0,0.003635
477,83C27F80,0,1,1,0.247863,0,0,0,0
478,7F2FA5E2,2,0,2,0,0,0.00589,0,0.009195
479,7F998740,0,1,1,0.242991,0,0,0.000049,0
480,810F5DF2,13,1,14,0.428571,53.888889,0.023949,0.006056,0.081475
481,764B432A,0,1,1,0.666667,0,0,0.000744,0
482,80567588,0,1,1,1,0,0,0.000092,0
483,8144FBBE,1,1,2,1,10,0.002461,0,0.018109
484,7192F17E,1,0,1,0,0,0,0,0.003635
485,7EE9E8F4,1,6,7,0.367347,20.5,0.000054,0.009625,0.003635
486,7F63D379,0,1,1,0.666667,0,0,0.000744,0
487,5F99A8A1,1,0,1,0,0,0.009279,0,0.023377
488,7EA5FBB7,2,0,2,0,0,0.000119,0,0.007271
489,79459D95,1,6,7,0.308511,140.666667,0.001089,0.005499,0.013938
490,7E221145,24,0,24,0,0,0.05098,0,0.284469
491,7C9177C7,2,2,4,0.304348,55,0.000257,0.000012,0.011118
492,7CF62DD1,0,2,2,0.666667,0,0,0.000006,0
493,7CC7DCBF,4,0,4,0,0,0.017233,0,0.06057
494,7EBB5463,3,0,3,0,0,0.000662,0,0.077857
495,7F2C0CAB,12,1,13,0.411765,50.166667,0.00277,0.003569,0.071503
496,7EDF7CD1,0,1,1,1,0,0,0.000047,0
497,793A8FD8,0,1,1,1,0,0,0.001017,0
498,7E6B20B0,0,3,3,0.375,0,0,0.000883,0
499,7F980C70,1,1,2,0.666667,25,0.00005,0,0.013418
500,78743FF2,27,3,30,1,1065.416667,0.008722,0.000032,0.500844
501,7FC54D2C,3,0,3,0,0,0.001981,0,0.010906
502,7DD9441D,4,4,8,0.7,38.5,0.00043,0.001006,0.055057
503,726D449C,1,0,1,0,0,0,0,0.003635
504,7F48A7E7,2,1,3,1,2,0.001478,0.067616,0.007271
505,7CF6F268,0,1,1,1,0,0,0.000987,0
506,7F7E4C7C,4,1,5,1,6,0.006131,0.000209,0.018389
507,7E1C5196,0,7,7,0.307692,0,0,0.02819,0
508,7715D53A,13,0,13,0,0,0.003053,0,0.084355
509,7EC7C69A,0,4,4,0.394558,0,0,0.0054,0
510,7CD867B1,1,0,1,0,0,0.000672,0,0.013254
511,7FB0B9E3,1,0,1,0,0,0.00466,0,0.005559
512,806DB873,0,1,1,1,0,0,0.000959,0
513,5B2D5F1E,0,6,6,0.8,0,0,0.00567,0
514,7611CBAF,0,4,4,0.56,0,0,0.001512,0
515,7E88E765,0,11,11,0.377953,0,0,0.014196,0
516,7DD9D5CF,0,1,1,1,0,0,0,0
517,7E808F2D,0,3,3,1,0,0,0.002305,0
518,76C011E7,116,0,116,0,0,0.793399,0,1
519,7D257679,0,5,5,0.578947,0,0,0.01417,0
520,7F252A65,0,2,2,0.666667,0,0,0.003743,0
521,7C7D3A42,0,2,2,0.75,0,0,0.000026,0
522,7D6784B8,0,1,1,1,0,0,0,0
523,7D11BA65,0,4,4,0.576923,0,0,0.02285,0
524,8127EF83,1,0,1,0,0,0,0,0.003635
525,801955C5,2,1,3,0.27907,4,0.000564,0,0.009195
526,7DBAC7AC,0,1,1,1,0,0,0,0
527,809CBA12,0,2,2,0.408163,0,0,0.000008,0
528,8037BA76,0,3,3,0.4,0,0,0.001417,0
529,643036AC,4,0,4,0,0,0.006079,0,0.033053
530,7ACF9470,8,1,9,1,16,0.026129,0.000693,0.043557
531,77A1785E,1,1,2,1,1,0,0.004493,0.003635
532,7D5B0CDE,0,3,3,0.666667,0,0,0.003854,0
533,7F9A99DF,0,1,1,0.6,0,0,0,0
534,7C44324B,1,0,1,0,0,0.000012,0,0.003635
535,815E2DF9,1,1,2,1,1,0,0,0.003635
536,7D2E460D,0,4,4,0.440476,0,0,0.005577,0
537,5EA8CFAD,0,1,1,1,0,0,0,0
538,8068B87B,0,3,3,1,0,0,0.007097,0
539,7E739329,2,1,3,0.666667,5,0.000004,0.000201,0.009698
540,7B744F14,0,1,1,0.388889,0,0,0,0
541,7C5DAA0E,5,0,5,0,0,0.02126,0,0.074208
542,8002C16A,0,11,11,0.416107,0,0,0.013663,0
543,7DA7CE14,0,3,3,0.318182,0,0,0.000073,0
544,81726E2D,0,2,2,0.470588,0,0,0.001122,0
545,7AC4C70F,0,7,7,0.461538,0,0,0.03305,0
546,7BB81DF8,1,0,1,0,0,0.000007,0,0.003635
547,7E93EE04,0,3,3,0.666667,0,0,0.025866,0
548,7E0BBE50,22,2,24,0.75,80.45,0.032088,0.006604,0.275644
549,7ECFB93B,0,2,2,1,0,0,0.004491,0
550,7F7189D7,1,0,1,0,0,0,0,0.003635
551,7F6DAD9F,0,4,4,0.346939,0,0,0.001325,0
552,7FC9EC9D,1,7,8,0.714286,30,0,0.002032,0.006063
553,7DD076E8,4,3,7,1,13.333333,0.006697,0.005871,0.02274
554,80A16C8A,1,2,3,0.461538,4.333333,0.000003,0.000019,0.003635
555,7A45B865,0,1,1,1,0,0,0.000101,0
556,7E57BF31,1,2,3,1,2,0,0.001607,0.003635
557,7FBB867F,0,1,1,1,0,0,0,0
558,8084A3B8,0,2,2,1,0,0,0,0
559,6F66FAB0,1,0,1,0,0,0,0,0.003635
560,5FC59087,6,0,6,0,0,0.013139,0,0.034362
561,7BEE35FF,0,5,5,0.666667,0,0,0.081481,0
562,7F3BF319,7,2,9,1,73.342857,0.032825,0.017461,0.097227
563,803D103C,0,1,1,1,0,0,0,0
564,80E86418,1,0,1,0,0,0,0,0.003635
565,5E9EC7FB,1,5,6,0.578947,2,0.000288,0.000968,0.003635
566,806F0AB8,1,0,1,0,0,0.000271,0,0.003635
567,7FAA7A65,7,2,9,0.444444,24,0.023367,0.005541,0.037998
568,77A852EE,1,0,1,0,0,0.000031,0,0.003635
569,5FCAE67F,0,1,1,1,0,0,0.067616,0
570,752AFECD,0,1,1,1,0,0,0.000712,0
571,806C7DA6,0,1,1,0.247059,0,0,0.000511,0
572,7D2537BC,1,4,5,0.526316,18,0.016102,0.007458,0.019026
573,7934D339,0,6,6,0.403509,0,0,0.01293,0
574,7E766C26,4,1,5,1,88,0.000289,0.000007,0.06798
575,805927FD,2,1,3,1,1,0.000256,0.000065,0.007271
576,7839BC52,0,1,1,1,0,0,0,0
577,75A3E948,0,3,3,0.714286,0,0,0.000038,0
578,797FB3E7,1,0,1,0,0,0.000103,0,0.003635
579,5F683EDE,3,10,13,0.916667,50.833333,0.013141,0.100289,0.013618
580,77E6A2FC,0,2,2,1,0,0,0.00085,0
581,7D6244A7,1,4,5,0.526316,18,0.000005,0.007581,0.005559
582,7741A0BD,11,0,11,0,0,0.018182,0,0.079326
583,805EBCD3,0,5,5,0.41791,0,0,0.015979,0
584,5CC80A36,0,1,1,1,0,0,0.000006,0
585,752D6D4D,0,3,3,0.8,0,0,0.005895,0
586,8008C736,1,7,8,0.390476,1.5,0.00176,0.015138,0.003635
587,5884FD4C,2,0,2,0,0,0.001246,0,0.007271
588,816994D9,5,2,7,1,38,0.001657,0.011407,0.044787
589,7A87B931,0,2,2,1,0,0,0.000104,0
590,7D071536,3,0,3,0,0,0.000004,0,0.01283
591,741789FD,0,2,2,0.4,0,0,0.000832,0
592,5B9F2967,2,3,5,0.5625,11.833333,0.008665,0.017732,0.007271
593,7F7BC44E,0,1,1,0.666667,0,0,0.000126,0
594,808807FD,1,0,1,0,0,0.002126,0,0.003635
595,7F6F9A21,3,1,4,1,3,0.007943,0.00026,0.010906
596,0289E6CB,0,1,1,1,0,0,0.004826,0
597,7F54C937,6,0,6,0,0,0.006866,0,0.028174
598,7C2120FB,1,0,1,0,0,0.00466,0,0.005559
599,76416E7D,0,3,3,1,0,0,0.000034,0
600,7AD58AB1,0,1,1,0.32,0,0,0.000236,0
601,80BF746D,4,1,5,0.5,1.766667,0.014618,0.002735,0.030113
602,7EB16941,0,1,1,1,0,0,0.006272,0
603,7EDB09FF,0,2,2,1,0,0,0.000087,0
604,5A233A76,1,3,4,0.529412,12,0.001217,0.006122,0.006653
605,7FC13864,1,0,1,0,0,0,0,0.003635
606,7619646B,0,9,9,0.34,0,0,0.042682,0
607,77F56FF8,0,3,3,1,0,0,0.068616,0
608,7AE11221,5,7,12,0.576923,56.416667,0.006502,0.007888,0.018177
609,8178EBF1,0,3,3,0.6,0,0,0.019591,0
610,59794D5D,0,7,7,0.38,0,0,0.009815,0
611,7BF2A83A,0,6,6,0.47619,0,0,0.00013,0
612,7FB07E59,0,1,1,0.37037,0,0,0.000002,0
613,7F5DE216,1,0,1,0,0,0,0,0.006063
614,7FA1ECA3,0,3,3,0.666667,0,0,0.000701,0
615,6DEBF7DA,0,4,4,0.833333,0,0,0.003072,0
616,7C0B5EB6,1,0,1,0,0,0.00006,0,0.003635
617,7F9C1295,2,4,6,1,9.5,0.006226,0.011839,0.009195
618,8051DAA9,0,3,3,1,0,0,0.005882,0
619,5AD2B953,0,1,1,1,0,0,0.000759,0
620,5B31E116,1,1,2,1,1,0,0,0.003635
621,80FF74D5,4,7,11,0.592593,48.95,0.018553,0.027793,0.035703
622,5A2F4F8D,0,2,2,0.75,0,0,0.006081,0
623,778A9EF1,4,0,4,0,0,0.024408,0,0.032757
624,668AD14B,1,0,1,0,0,0.005685,0,0.003635
625,7DD65D41,1,0,1,0,0,0.000643,0,0.003635
626,7E08F455,0,1,1,0.354839,0,0,0.000252,0
627,80F70048,3,0,3,0,0,0.000868,0,0.055822
628,7EF240AB,4,4,8,0.5,90,0.006735,0.028685,0.016465
629,7DA31ADA,2,4,6,1,8.5,0.001005,0.024439,0.009195
630,796EECE0,0,3,3,0.37037,0,0,0.000906,0
631,7AA39B0A,1,0,1,0,0,0.000116,0,0.003635
632,7F667C32,2,5,7,1,8.333333,0.000002,0.003278,0.009195
633,7BAB64B5,1,0,1,0,0,0,0,0.003635
634,7DF83C78,53,0,53,0,0,0.163316,0,0.439215
635,5FDA5BC5,1,0,1,0,0,0,0,0.003635
636,7CF64C41,2,2,4,0.75,9.666667,0.000245,0.001184,0.011118
637,7FCEED10,3,2,5,1,6,0.000005,0,0.01283
638,8133D5AC,9,11,20,0.447059,455.583333,0.015061,0.117337,0.042841
639,7EBE0956,0,3,3,0.571429,0,0,0.00006,0
640,77D4F75B,1,0,1,0,0,0.000006,0,0.005559
641,7E1F3F6C,0,1,1,1,0,0,0,0
642,7DBE5D4A,0,1,1,1,0,0,0.00001,0
643,7D808793,3,0,3,0,0,0.00136,0,0.010906
644,5E137B33,2,0,2,0,0,0.000741,0,0.007271
645,7F107395,1,1,2,1,8,0.00048,0,0.011004
646,7F82D21B,1,3,4,0.636364,0.333333,0,0.000025,0.003635
647,7F023626,0,5,5,0.857143,0,0,0.000682,0
648,7CEDB5F5,7,10,17,0.404762,463.642857,0.020653,0.036965,0.049037
649,7DAE0070,0,4,4,0.304825,0,0,0.000946,0
650,7FA2D2BA,9,0,9,0,0,0.015852,0,0.044765
651,7E194D18,4,0,4,0,0,0.008708,0,0.018389
652,80060C40,2,1,3,1,2,0.000003,0.00729,0.007271
653,81064F98,2,8,10,0.385714,37,0.001009,0.013943,0.007271
654,7D820EBF,5,3,8,0.714286,26,0.002183,0.000107,0.020101
655,7BC7DC99,1,4,5,0.5,30,0.00585,0.020724,0.005559
656,7FA28856,0,1,1,1,0,0,0.000233,0
657,7D7F5EB7,0,1,1,0.5,0,0,0.00296,0
658,7F79C506,2,3,5,0.8,8.666667,0.002114,0.002476,0.009195
659,7D3E35DC,2,0,2,0,0,0.000035,0,0.007271
660,7F7F7CE4,0,6,6,0.452381,0,0,0.000516,0
661,7798E6C8,1,0,1,0,0,0,0,0.003635
662,78A12D98,0,7,7,0.383333,0,0,0.01024,0
663,7FBD5DD3,2,1,3,1,0.5,0.001204,0.001585,0.009195
664,7DC97E32,2,0,2,0,0,0.001443,0,0.007271
665,7AE79D7C,2,0,2,0,0,0.000168,0,0.014966
666,7F9053C4,1,7,8,0.361111,24,0.000484,0.006256,0.003635
667,80CA3D06,0,2,2,0.625,0,0,0.015377,0
668,7F203572,0,3,3,1,0,0,0.001,0
669,75182472,0,1,1,1,0,0,0.067616,0
670,7E22277C,3,0,3,0,0,0.000004,0,0.01283
671,7618D483,1,0,1,0,0,0.000011,0,0.003635
672,7EC0ED44,0,2,2,1,0,0,0.002613,0
673,7AB33B2D,13,0,13,0,0,0.031948,0,0.095119
674,7F8052C7,0,1,1,0.666667,0,0,0.000296,0
675,7E1DF5E6,2,2,4,0.545455,1,0.000022,0.000014,0.007271
676,7B7737BE,1,0,1,0,0,0.000699,0,0.003635
677,7973375D,0,1,1,1,0,0,0.017271,0
678,81670AE0,0,2,2,0.75,0,0,0.004939,0
679,803888CF,1,0,1,0,0,0.008886,0,0.003635
680,7E6E031F,0,1,1,0.666667,0,0,0.006242,0
681,7F75F168,1,0,1,0,0,0.000262,0,0.003635
682,7FD5E71B,0,3,3,0.434783,0,0,0.000004,0
683,7E73F38C,2,2,4,0.6,20,0.00015,0.004801,0.011118
684,7ED89510,1,2,3,1,0.5,0.000392,0.006825,0.003635
685,7D01AAC4,0,7,7,0.888889,0,0,0.014519,0
686,7DAEA624,0,2,2,1,0,0,0.00001,0
687,7E39C375,0,1,1,1,0,0,0.000312,0
688,7F702784,6,1,7,1,4.666667,0.012746,0.015057,0.023736
689,7A16BFAB,0,11,11,0.330137,0,0,0.004434,0
690,7EFE0982,7,1,8,1,10.5,0.030881,0.001428,0.064698
691,7DF99263,1,1,2,0.375,11,0.000215,0.00001,0.003635
692,5F8E5888,2,0,2,0,0,0.000468,0,0.007271
693,5E8FAE98,9,0,9,0,0,0.000247,0,0.09239
694,76BD242D,1,0,1,0,0,0,0,0.031643
695,6DBCE199,0,3,3,0.5,0,0,0.0071,0
696,58E323D6,5,0,5,0,0,0.005581,0,0.022025
697,7DC0D454,0,3,3,0.8,0,0,0.000305,0
698,7E8CE715,0,1,1,1,0,0,0,0
699,812B3794,0,1,1,1,0,0,0,0
700,79E9F5F9,0,2,2,1,0,0,0.068682,0
701,7E3250AB,0,1,1,1,0,0,0.00087,0
702,6FA6373B,2,0,2,0,0,0.000064,0,0.03012
703,7790AE4B,1,0,1,0,0,0.000056,0,0.003635
704,766CD22A,0,2,2,0.75,0,0,0.001619,0
705,7D57D837,0,1,1,0.345794,0,0,0.000948,0
706,7E98588E,0,1,1,1,0,0,0.000323,0
707,778BA47F,0,2,2,1,0,0,0,0
708,7D716869,3,2,5,0.75,12,0.006107,0.007353,0.01283
709,596DAD59,7,0,7,0,0,0.016881,0,0.033647
710,7DBD8A23,9,1,10,1,27.333333,0.002357,0.000019,0.069717
711,805680F9,3,0,3,0,0,0.016557,0,0.056935
712,6F386EC3,6,0,6,0,0,0.001641,0,0.038662
713,80CEC43A,0,3,3,0.6,0,0,0.000686,0
714,7B903CA8,3,0,3,0,0,0.018346,0,0.036096
715,7D5B6538,0,4,4,0.482143,0,0,0.015929,0
716,759D5797,1,5,6,0.336842,6.5,0.000054,0.007166,0.003635
717,757C666D,23,2,25,1,150.333333,0.081382,0.007809,0.224261
718,5FBCDA49,1,0,1,0,0,0,0,0.003635
719,74884E60,1,4,5,0.363636,30.75,0.000378,0.003324,0.003635
720,7FBE3FD4,0,2,2,1,0,0,0.001857,0
721,75994D2A,9,0,9,0,0,0.008358,0,0.047192
722,7E511F66,2,0,2,0,0,0.000012,0,0.009195
723,7F8B1175,0,6,6,0.394737,0,0,0.01088,0
724,7FF589F3,0,3,3,0.714286,0,0,0.000032,0
725,7A6D02AA,0,2,2,0.444444,0,0,0.00462,0
726,05CB5D9F,1,0,1,0,0,0,0,0.005559
727,5A82F00C,0,2,2,1,0,0,0.000064,0
728,7A74859E,0,8,8,0.344828,0,0,0.020905,0
729,7FC18B59,1,0,1,0,0,0.00021,0,0.007483
730,7F7100F1,0,2,2,0.387097,0,0,0.001387,0
731,7633BAA2,1,0,1,0,0,0.000464,0,0.003635
732,7EDB77D9,0,1,1,0.6,0,0,0.006235,0
733,807AAA5E,2,0,2,0,0,0,0,0.013546
734,7E500579,2,6,8,0.526316,13,0.011421,0.118418,0.011118
735,7F40FD09,0,1,1,1,0,0,0,0
736,7F44E4C4,0,1,1,1,0,0,0.00729,0
737,7EF83489,5,0,5,0,0,0.007131,0,0.02981
738,80E47EC5,0,3,3,0.615385,0,0,0.000005,0
739,71AADC31,1,0,1,0,0,0.010689,0,0.006063
740,7E0F2F01,0,3,3,0.6,0,0,0.004885,0
741,5B7BF3DE,4,0,4,0,0,0.001423,0,0.014542
742,59C118C4,2,0,2,0,0,0.000004,0,0.011622
743,5C4719BB,1,0,1,0,0,0.001863,0,0.003635
744,7DB4F8D6,0,1,1,1,0,0,0,0
745,801EACEF,1,0,1,0,0,0.000456,0,0.005559
746,7EC3668E,0,2,2,0.5,0,0,0.006986,0
747,0B7FCB41,7,3,10,1,402.383333,0.000634,0.000032,0.301923
748,76872626,0,5,5,1,0,0,0.015765,0
749,7F1B0D58,3,0,3,0,0,0.008414,0,0.043686
750,80FED0F2,0,3,3,0.571429,0,0,0.000203,0
751,0887F944,5,0,5,0,0,0.007787,0,0.172621
752,7E8C4F22,1,6,7,0.666667,11,0.005685,0.000092,0.003635
753,7EEEAF03,0,10,10,0.312242,0,0,0.075678,0
754,7D578921,0,13,13,0.355072,0,0,0.024945,0
755,810BB703,0,1,1,1,0,0,0.067616,0
756,804C10CC,2,2,4,0.320312,81,0.005998,0.017724,0.007271
757,7D7172EE,0,2,2,1,0,0,0.068295,0
758,7E6ED1DF,4,0,4,0,0,0.001777,0,0.016465
759,7E1798A8,1,0,1,0,0,0.002886,0,0.003635
760,79BF62E1,1,0,1,0,0,0.000003,0,0.003635
761,7D206938,2,1,3,1,2,0.007853,0.015057,0.009195
762,80A322D1,1,1,2,1,1,0.000267,0,0.003635
763,63E550E4,1,0,1,0,0,0.000025,0,0.003635
764,7DD715BD,4,1,5,1,1.5,0.006022,0.001594,0.014542
765,80779CC0,4,3,7,0.413793,33.052381,0.027329,0.00765,0.041474
766,77ABB5BC,0,1,1,0.666667,0,0,0.000201,0
767,59A6DAF1,0,9,9,0.443038,0,0,0.089203,0
768,7FC70AF8,0,2,2,0.571429,0,0,0,0
769,70184CDD,0,1,1,1,0,0,0,0
770,7F6054CA,0,2,2,0.357143,0,0,0.000283,0
771,5EA2C978,1,0,1,0,0,0,0,0.003635
772,7F08E039,0,3,3,0.666667,0,0,0.00577,0
773,7944D193,2,1,3,1,3,0.000018,0,0.009195
774,7A9B934E,3,0,3,0,0,0.006222,0,0.04561
775,7D3034D4,1,0,1,0,0,0.00643,0,0.006063
776,7A92FD67,0,1,1,0.409091,0,0,0.0003,0
777,5CE20808,1,0,1,0,0,0.016102,0,0.019026
778,77C5DDCF,1,0,1,0,0,0.000075,0,0.003635
779,80854C45,0,3,3,0.363636,0,0,0.006087,0
780,79468588,0,1,1,0.666667,0,0,0.000837,0
781,80C3EDC0,1,3,4,1,3,0.000085,0.000987,0.003635
782,802FEFB1,0,1,1,1,0,0,0.00001,0
783,7DE17922,3,0,3,0,0,0.000416,0,0.013837
784,7F29AA45,0,1,1,0.555556,0,0,0.003931,0
785,8061DF3D,0,3,3,0.8,0,0,0.009277,0
786,804AF37B,0,1,1,1,0,0,0.000001,0
787,7F01AC6A,0,1,1,1,0,0,0.002715,0
788,7EE87CF2,2,1,3,0.666667,3,0.00037,0.000837,0.007271
789,80D746EF,1,0,1,0,0,0.001396,0,0.003635
790,767F5EB9,0,1,1,1,0,0,0.00531,0
791,7FD6BE85,0,1,1,1,0,0,0.003126,0
792,7F02BF49,0,2,2,1,0,0,0.00539,0
793,025B47E4,1,7,8,0.305389,0,0.001261,0.012555,0.003635
794,80403E0C,1,3,4,0.8,1.5,0.000203,0.008382,0.003635
795,7DAB96BC,1,0,1,0,0,0.005685,0,0.003635
796,801B0E81,7,1,8,1,10.166667,0.006266,0.006272,0.180722
797,5ED7662C,0,2,2,1,0,0,0,0
798,7D4028A5,10,0,10,0,0,0.016244,0,0.089838
799,7F8BAD07,2,0,2,0,0,0.000017,0,0.007271
800,804FC264,19,0,19,0,0,0.049751,0,0.180046
801,5E9C2A2C,0,2,2,0.287671,0,0,0.000784,0
802,7D5CFEFC,0,1,1,1,0,0,0.000191,0
803,75A9F695,1,4,5,0.325397,33,0.00002,0.006347,0.003635
804,748A37E5,2,0,2,0,0,0.00014,0,0.017897
805,75876763,1,0,1,0,0,0,0,0.003635
806,7F4EA3AD,2,2,4,0.75,3,0.007726,0.007001,0.007271
807,7D678209,0,1,1,0.5,0,0,0.000006,0
808,7DFFE2C1,0,6,6,0.333333,0,0,0.016403,0
809,0895A9B7,0,3,3,0.267327,0,0,0.000041,0
810,788E7ADD,0,1,1,1,0,0,0.004493,0
811,7D803863,5,0,5,0,0,0.013026,0,0.035165
812,8136CA16,0,2,2,0.325758,0,0,0,0
813,8112A0B0,2,0,2,0,0,0.006676,0,0.007271
814,7DAF1CB7,1,4,5,0.365385,1,0.000606,0.002922,0.003635
815,801D7296,0,2,2,1,0,0,0.005497,0
816,5E638829,1,1,2,0.571429,0,0.000139,0.001581,0.003635
817,74C45B15,1,0,1,0,0,0,0,0.003635
818,77A39E44,2,0,2,0,0,0.000061,0,0.017393
819,81734E7A,2,0,2,0,0,0.000445,0,0.009785
820,7E5F918B,4,4,8,0.75,29,0.019029,0.009181,0.042847
821,7E05CFD7,1,0,1,0,0,0,0,0.003635
822,7DC3DC6B,0,1,1,0.345794,0,0,0.000948,0
823,7FB97B9E,0,1,1,0.448276,0,0,0.013735,0
824,8128107F,1,0,1,0,0,0.000081,0,0.010591
825,7D30738A,0,1,1,0.666667,0,0,0,0
826,8007E237,1,0,1,0,0,0.000538,0,0.003635
827,78B1F67B,1,0,1,0,0,0.000378,0,0.003635
828,7FFC70D1,2,0,2,0,0,0.000269,0,0.007271
829,8028C7C9,0,1,1,1,0,0,0.000636,0
830,7EB1B3B5,0,1,1,0.448276,0,0,0.013735,0
831,7F7DE18A,1,0,1,0,0,0,0,0.003635
832,7F5038EF,0,2,2,0.75,0,0,0.004185,0
833,76A97834,1,0,1,0,0,0.000018,0,0.003635
834,7CE4C6D9,0,2,2,0.363636,0,0,0.002056,0
835,7CC9A64B,0,2,2,0.384615,0,0,0.006654,0
836,7B38B68D,1,0,1,0,0,0.00018,0,0.003635
837,7F3956CB,9,0,9,0,0,0.013884,0,0.075349
838,5E57CF43,4,0,4,0,0,0.010859,0,0.042481
839,7DD4F5B7,0,2,2,0.351852,0,0,0.000955,0
840,76AD4806,5,0,5,0,0,0.020841,0,0.033567
841,790145A5,1,3,4,1,3,0.000048,0.000066,0.003635
842,7FCC1878,1,0,1,0,0,0.000568,0,0.003635
843,8045AAA2,5,0,5,0,0,0.001053,0,0.042624
844,7F0765AA,0,10,10,0.372222,0,0,0.007322,0
845,59AFBF73,0,1,1,1,0,0,0.004771,0
846,8083CE1C,1,1,2,0.342857,3,0.000038,0,0.003635
847,834DCDFD,2,0,2,0,0,0.003682,0,0.011118
848,812EAC8F,8,2,10,1,32.5,0.018108,0.001766,0.052672
849,7D2CCE8B,0,4,4,0.5,0,0,0.009187,0
850,808C0A43,1,0,1,0,0,0.001494,0,0.003635
851,7D327F9A,9,0,9,0,0,0.007199,0,0.042338
852,7DEB9C38,23,2,25,0.6,315,0.041879,0.001685,0.192992
853,81107924,1,2,3,1,4,0.003494,0.000486,0.005559
854,5F3B4971,1,0,1,0,0,0.001478,0,0.005559
855,798D7604,1,0,1,0,0,0.000018,0,0.003635
856,8131E7E7,1,0,1,0,0,0.000025,0,0.003635
857,78958C7C,1,0,1,0,0,0.000038,0,0.003635
858,80755186,0,1,1,1,0,0,0.000902,0
859,7DED933F,0,1,1,1,0,0,0.003108,0
860,7E89AD97,22,0,22,0,0,0.056632,0,0.204928
861,7F3A65C6,6,0,6,0,0,0.003523,0,0.056055
862,7B23C453,1,0,1,0,0,0,0,0.003635
863,7D763231,3,5,8,0.367925,122.166667,0.005643,0.009585,0.015257
864,5ECD5226,5,5,10,0.5,838.140476,0.004119,0.000413,0.124116
865,7EBC726B,1,1,2,1,0.5,0.00003,0.000312,0.003635
866,7E940BF4,1,0,1,0,0,0,0,0.003635
867,757F9211,0,1,1,0.294118,0,0,0.000063,0
868,58CBEA74,2,0,2,0,0,0.001029,0,0.007271
869,8013AFC8,2,1,3,1,2,0.000005,0.000312,0.007271
870,804A2B61,2,1,3,1,2,0.001066,0,0.007271
871,7DDEFE10,6,0,6,0,0,0.000765,0,0.110172
872,804EA653,0,1,1,1,0,0,0,0
873,04EA0DA9,0,1,1,0.372093,0,0,0.000536,0
874,81682BC1,1,1,2,0.666667,2,0,0.000495,0.003635
875,7E57E203,0,4,4,0.290909,0,0,0.011374,0
876,76168214,3,0,3,0,0,0.000115,0,0.010906
877,80D1B451,0,2,2,0.265753,0,0,0.005575,0
878,7739420E,1,0,1,0,0,0.000215,0,0.003635
879,74E9F815,1,0,1,0,0,0,0,0.003635
880,80841AF4,0,2,2,1,0,0,0.00643,0
881,7E91834C,13,4,17,1,307.5,0.046127,0.079427,0.188379
882,7F14F166,0,2,2,1,0,0,0.001192,0
883,7D4F9594,0,3,3,1,0,0,0.076502,0
884,8057CD15,0,2,2,1,0,0,0.007278,0
885,80D5198E,1,1,2,0.666667,1,0.000046,0.000034,0.003635
886,7EA439B2,1,0,1,0,0,0.001478,0,0.005559
887,6011C74A,5,0,5,0,0,0.001075,0,0.018177
888,7E6DF7F6,0,7,7,0.888889,0,0,0.004314,0
889,8019D587,0,9,9,0.278317,0,0,0.015443,0
890,71AA5881,3,0,3,0,0,0.012512,0,0.014754
891,8045D7E4,4,3,7,0.329114,90.5,0.003505,0.004926,0.014542
892,79532D15,1,0,1,0,0,0,0,0.003635
893,79BCCF32,0,4,4,0.615385,0,0,0.001806,0
894,7F900EF9,5,2,7,0.555556,21,0.017937,0.078586,0.040019
895,782A0931,3,0,3,0,0,0.000041,0,0.01283
896,08639F7A,0,1,1,1,0,0,0.00013,0
897,772B83E6,0,1,1,1,0,0,0.000022,0
898,7758011B,0,5,5,0.857143,0,0,0.000273,0
899,7EAF07DD,0,1,1,0.30303,0,0,0.000636,0
900,75240328,2,0,2,0,0,0.000023,0,0.007271
901,7DD2A9AF,0,3,3,1,0,0,0.00164,0
902,6CB537EB,0,1,1,0.666667,0,0,0.001533,0
903,7FA8B3A8,0,3,3,0.714286,0,0,0.002015,0
904,76558AAF,1,1,2,1,0,0,0,0.005559
905,7CF0DB67,4,4,8,0.441176,10.209524,0.005092,0.018254,0.016465
906,80009258,1,3,4,0.714286,4.5,0.000002,0.008417,0.003635
907,813BA468,3,4,7,0.4,57,0.000833,0.003245,0.014754
908,674562E1,1,0,1,0,0,0.000694,0,0.005559
909,7A439CAC,2,0,2,0,0,0.001834,0,0.007271
910,7A8711C5,0,1,1,1,0,0,0,0
911,7E67CCD5,1,1,2,1,1,0.000001,0,0.003635
912,7E553D4A,0,4,4,0.362069,0,0,0.024007,0
913,7F3D7EE3,25,2,27,1,46.666667,0.073163,0.018575,0.155054
914,6EC35316,0,3,3,0.8,0,0,0.000016,0
915,073C8978,2,0,2,0,0,0.000313,0,0.007271
916,8090D764,4,0,4,0,0,0,0,0.020817
917,800A2FE1,0,1,1,0.333333,0,0,0.002041,0
918,6B362D14,1,0,1,0,0,0.000269,0,0.006063
919,7D33937F,1,0,1,0,0,0,0,0.003635
920,050F1410,0,1,1,1,0,0,0,0
921,7F10BAEB,0,4,4,0.452381,0,0,0.00381,0
922,7D903BED,0,4,4,0.375,0,0,0.000399,0
923,7F0DEE9E,2,3,5,1,8.75,0.004511,0.021389,0.014966
924,005A9276,1,0,1,0,0,0,0,0.003635
925,7CD4F8C8,0,2,2,0.362069,0,0,0.005813,0
926,7D31881F,1,1,2,0.666667,2,0.000271,0,0.003635
927,80E0ED3F,1,0,1,0,0,0.016102,0,0.019026
928,7D74FFAC,2,5,7,0.777778,4.583333,0.003169,0.01454,0.017574
929,62183AFF,1,0,1,0,0,0.000164,0,0.003635
930,7C8BDE40,0,4,4,0.288235,0,0,0.000237,0
931,7D6D8A2C,0,1,1,1,0,0,0.00004,0
932,7616E53D,31,0,31,0,0,0.073593,0,0.687375
933,7D6B2BA8,8,2,10,1,17.583333,0.017806,0.006427,0.088833
934,65788654,1,0,1,0,0,0.00347,0,0.005559
935,7F165C51,1,7,8,0.538462,19,0.007602,0.058436,0.003635
936,7CAB5EF8,1,1,2,1,1,0,0,0.003635
937,06BC71FD,25,0,25,0,0,0.085535,0,0.319437
938,7EB3E3AF,1,1,2,0.666667,2,0.00002,0.000523,0.003635
939,7F232663,0,4,4,0.555556,0,0,0.006628,0
940,7A3F28E3,0,1,1,1,0,0,0.000159,0
941,7F88127A,0,2,2,0.555556,0,0,0.000885,0
942,8172B176,0,1,1,1,0,0,0.001625,0
943,75128D2D,2,0,2,0,0,0.00018,0,0.007271
944,09C48F71,3,0,3,0,0,0.011255,0,0.014754
945,7FB18F9F,1,0,1,0,0,0.001036,0,0.003635
946,7E40A3AE,0,5,5,0.342857,0,0,0.003911,0
947,7FEB61E6,0,1,1,1,0,0,0,0
948,7E11CA18,0,1,1,1,0,0,0.001299,0
949,801C71B0,0,7,7,0.425532,0,0,0.002844,0
950,08F0A0F7,1,1,2,1,1,0,0.004826,0.003635
951,7CFD113B,0,8,8,0.333333,0,0,0.024433,0
952,80A58351,2,2,4,0.295455,13.5,0.000812,0.000078,0.007271
953,7C7A82C5,3,4,7,0.833333,13.666667,0.017875,0.010818,0.02822
954,7E42986F,0,2,2,1,0,0,0.000207,0
955,804329A5,1,0,1,0,0,0.000683,0,0.003635
956,7E62495E,0,4,4,0.7,0,0,0.001628,0
957,7E2B26EF,1,1,2,0.283784,0,0.000593,0.00027,0.003635
958,767F16A9,2,0,2,0,0,0.000046,0,0.007271
959,7D222606,2,2,4,1,3.5,0.000161,0.000025,0.007271
960,75CF7119,0,1,1,0.350318,0,0,0.001192,0
961,7A136BDA,1,0,1,0,0,0.000334,0,0.003635
962,812DDDB8,12,4,16,0.7,91.5,0.008589,0.001114,0.057091
963,599B9529,1,0,1,0,0,0,0,0.003635
964,7AEF1B44,0,1,1,0.354839,0,0,0.000169,0
965,8035614B,5,0,5,0,0,0.014529,0,0.037682
966,75CE9B3E,0,1,1,0.354839,0,0,0.000252,0
967,800B8B14,3,1,4,1,6.5,0.017494,0.000323,0.014526
968,809257FC,0,1,1,1,0,0,0.000233,0
969,7DBDF1D8,0,2,2,0.307692,0,0,0.005407,0
970,8045F6B6,0,1,1,1,0,0,0,0
971,7FA11DAC,2,1,3,1,5,0.000009,0.000037,0.013042
972,7CB5DD04,5,0,5,0,0,0.012917,0,0.023948
973,589123F6,0,2,2,0.75,0,0,0.006288,0
974,800C491B,0,1,1,1,0,0,0,0
975,7E951C8D,25,4,29,0.529412,434,0.065751,0.007383,0.169951
976,5882FF7A,2,1,3,1,1,0.000589,0.000157,0.007271
977,713FEB6E,1,0,1,0,0,0.000054,0,0.003635
978,8069A46D,3,4,7,1,11.666667,0.000006,0.000611,0.016264
979,5CC5B3B3,0,1,1,0.666667,0,0,0.000069,0
980,7F6A420D,0,3,3,0.364706,0,0,0.001889,0
981,7EA68905,0,1,1,0.266667,0,0,0,0
982,7F481635,1,0,1,0,0,0.000269,0,0.006063
983,7F18C0E1,0,7,7,0.372727,0,0,0.007025,0
984,7F54CDC6,3,4,7,0.833333,13,0.000024,0.001633,0.014754
985,7E37CC9A,2,1,3,1,8,0.000578,0.000007,0.012386
986,7E72CBEC,1,0,1,0,0,0.000309,0,0.003635
987,7AEC0136,3,0,3,0,0,0.001147,0,0.025536
988,775E7309,0,2,2,0.327586,0,0,0.00017,0
989,79B99DA4,0,9,9,0.311404,0,0,0.037311,0
990,802B99FE,5,0,5,0,0,0.02877,0,0.053308
991,7EA923E4,2,2,4,0.375,12,0.000741,0.000821,0.007271
992,8141C222,1,3,4,0.8,0,0.000585,0.006814,0.014261
993,77B67245,10,1,11,1,14.666667,0.035053,0.000246,0.082245
994,801A995C,1,0,1,0,0,0.000046,0,0.003635
995,7F8693AE,1,1,2,1,1,0,0,0.003635
996,7CF16961,0,2,2,1,0,0,0.000415,0
997,7CFE04F1,1,0,1,0,0,0.000133,0,0.003635
998,702A4908,1,0,1,0,0,0.000801,0,0.007483
999,7EB067F8,0,4,4,1,0,0,0.000198,0
1000,801D5B97,0,2,2,1,0,0,0,0
1001,7E0086A5,0,1,1,1,0,0,0.000233,0
1002,7DB20CA8,0,2,2,0.413793,0,0,0.000105,0
1003,8074C4BE,0,1,1,0.319149,0,0,0.001472,0
1004,817A37A8,1,1,2,0.6,0.5,0.007602,0.006235,0.003635
1005,5F551CD1,4,0,4,0,0,0.000177,0,0.016465
1006,7FFEF792,0,2,2,0.555556,0,0,0.000028,0
1007,7A79F203,0,1,1,0.248366,0,0,0,0
1008,77CE3201,1,1,2,1,2,0,0,0.005559
1009,7F4EB7BD,1,0,1,0,0,0.005893,0,0.005559
1010,7D8C7099,0,2,2,0.351852,0,0,0.002869,0
1011,7D7C65B1,1,0,1,0,0,0,0,0.01181
1012,7D5CAE14,1,4,5,0.328,34.2,0.00466,0.075071,0.005559
1013,7EB2DD38,0,2,2,1,0,0,0.000047,0
1014,7CA1BF73,2,7,9,0.431034,37.166667,0.001271,0.02278,0.007271
1015,80C2BC23,1,0,1,0,0,0.000077,0,0.003635
1016,7F8F3E47,0,1,1,1,0,0,0.000035,0
1017,7F74DD38,0,2,2,0.75,0,0,0.004885,0
1018,7D272D21,1,1,2,1,4,0.000068,0.001557,0.010917
1019,80B76D48,0,1,1,1,0,0,0.067616,0
1020,6296AB67,1,1,2,1,1,0.000414,0,0.003635
1021,7F2A6CA1,0,2,2,0.75,0,0,0.068293,0
1022,7CB1EC70,0,1,1,0.248366,0,0,0,0
1023,0A1D5989,0,3,3,0.470588,0,0,0.001587,0
1024,7EC74C62,0,3,3,0.357798,0,0,0.001291,0
1025,8080F635,1,2,3,1,0,0.000767,0.001712,0.003635
1026,7D763352,6,5,11,0.423077,206,0.01527,0.077467,0.035279
1027,5ED91B2C,1,0,1,0,0,0.000605,0,0.003635
1028,76A165CA,1,0,1,0,0,0.000051,0,0.003635
1029,5D218004,0,2,2,0.349057,0,0,0.004074,0
1030,77455AFB,0,2,2,0.240506,0,0,0,0
1031,7840D85E,1,0,1,0,0,0.000164,0,0.005559
1032,7DD8E24E,1,0,1,0,0,0.000271,0,0.003635
1033,7CDEE7FF,0,6,6,0.386364,0,0,0.01991,0
1034,8173E768,3,1,4,1,6.5,0.015257,0.001754,0.030647
1035,7D007780,4,0,4,0,0,0.016751,0,0.088858
1036,7FF5F63A,1,1,2,0.666667,0,0.000104,0.000018,0.003635
1037,7A3C384E,1,0,1,0,0,0.000767,0,0.003635
1038,7E0E16FA,0,2,2,0.571429,0,0,0.000623,0
1039,7CF0DF09,1,3,4,0.387097,12,0,0.001973,0.003635
1040,5E9AB41C,0,1,1,1,0,0,0.001754,0
1041,7E9AACF3,1,2,3,1,2,0.000001,0.005349,0.003635
1042,7EF98CB6,0,1,1,1,0,0,0.000001,0
1043,6D22ADB8,3,0,3,0,0,0.000459,0,0.025053
1044,586288E9,0,14,14,0.426573,0,0,0.05877,0
1045,7E57AF9B,0,1,1,0.352941,0,0,0,0
1046,809A7BA4,1,0,1,0,0,0.003494,0,0.005559
1047,814E9D21,0,1,1,0.424242,0,0,0.005047,0
1048,7F85CC90,2,4,6,1,20,0.003755,0.030919,0.015469
1049,76C4EF1C,1,0,1,0,0,0.000389,0,0.003635
1050,7EC188C3,0,5,5,0.484848,0,0,0.006404,0
1051,7EDCBE0B,0,2,2,1,0,0,0.000025,0
1052,8021A96C,2,0,2,0,0,0.000741,0,0.007271
1053,7F428B42,0,2,2,0.555556,0,0,0.000647,0
1054,770F6AAF,4,1,5,1,5,0.006179,0.000294,0.018389
1055,803D780C,1,4,5,0.416667,10,0,0.008786,0.003635
1056,6DA609C6,0,1,1,1,0,0,0.067616,0
1057,7F16539D,0,1,1,1,0,0,0,0
1058,5FE10C43,1,0,1,0,0,0.016102,0,0.019026
1059,80204C52,1,2,3,1,2,0.000894,0.006427,0.003635
1060,7E08A9BE,8,4,12,0.466667,351.166667,0.024256,0.019805,0.065399
1061,739B4C32,0,2,2,0.266904,0,0,0.000295,0
1062,7F61CCA9,0,5,5,0.857143,0,0,0.002066,0
1063,7D662126,4,6,10,0.387755,127.142857,0.009991,0.026473,0.024664
1064,7F5D6340,0,1,1,1,0,0,0.000664,0
1065,7D99BDD2,1,3,4,1,1,0.000026,0.001205,0.003635
1066,7FA70E2D,0,4,4,0.44186,0,0,0.025927,0
1067,7FC4B424,1,1,2,0.333333,0,0.000397,0.001991,0.005559
1068,7F17D2D4,0,1,1,1,0,0,0.000312,0
1069,7EACC709,0,1,1,1,0,0,0.000902,0
1070,7D2FE127,5,0,5,0,0,0.023503,0,0.067256
1071,7F094AFE,0,1,1,1,0,0,0,0
1072,80AF71E2,0,1,1,0.354839,0,0,0.000252,0
1073,802AC112,1,0,1,0,0,0.000836,0,0.003635
1074,7F5CE2AB,0,6,6,0.8,0,0,0.037,0
1075,0076E86C,1,0,1,0,0,0.006742,0,0.01133
1076,7688B060,0,4,4,0.458333,0,0,0.000603,0
1077,80CD7059,0,2,2,0.470588,0,0,0.000006,0
1078,03B881E3,1,0,1,0,0,0.000028,0,0.003635
1079,7F2BDC95,0,1,1,1,0,0,0.000045,0
1080,82124724,6,0,6,0,0,0.000627,0,0.035782
1081,7935E6D8,0,2,2,0.35,0,0,0.000386,0
1082,7EE44142,5,4,9,0.476923,241,0.003433,0.000189,0.026376
1083,75BB9230,0,3,3,0.8,0,0,0.068613,0
1084,7F15B843,0,1,1,1,0,0,0,0
1085,76926CA0,0,1,1,1,0,0,0,0
1086,5A74FF79,0,1,1,1,0,0,0.000019,0
1087,7D892077,1,3,4,0.8,16,0.000285,0.000204,0.009407
1088,750E01B4,0,1,1,0.281553,0,0,0.003989,0
1089,7FE762D2,1,5,6,0.345679,23.666667,0.003494,0.017696,0.005559
1090,7A5C00EE,0,7,7,0.5,0,0,0.009272,0
1091,7D9076E4,1,2,3,0.666667,2.5,0.00176,0.001557,0.003635
1092,7E04A76E,1,2,3,0.4375,7,0.000001,0.000883,0.003635
1093,80929A4E,1,0,1,0,0,0.000024,0,0.003635
1094,5F57102B,16,0,16,0,0,0.020577,0,0.126868
1095,68D21273,6,1,7,1,3,0.001334,0.00026,0.023736
1096,7E7042C4,0,1,1,0.354839,0,0,0.000252,0
1097,797F4098,0,1,1,1,0,0,0.001101,0
1098,7903EBD2,0,7,7,0.33945,0,0,0.010495,0
1099,0E552985,1,0,1,0,0,0.001632,0,0.009407
1100,7E107F40,1,5,6,0.354839,14,0.00466,0.003154,0.005559
1101,7F6CED0C,0,8,8,0.462963,0,0,0.096558,0
1102,808D1DD3,2,6,8,0.517241,60,0.000287,0.006988,0.013042
1103,7A05626F,3,0,3,0,0,0.005176,0,0.01283
1104,7E856849,0,2,2,0.538462,0,0,0.000036,0
1105,7CA8FB87,1,0,1,0,0,0.000161,0,0.003635
1106,7FB76160,1,0,1,0,0,0.000119,0,0.003635
1107,7E070C86,2,2,4,1,2.5,0.003432,0.018575,0.007271
1108,7F0FE5B7,1,0,1,0,0,0,0,0.003635
1109,5D08820F,4,1,5,1,0.5,0.022107,0.003832,0.016969
1110,77B37AB3,0,4,4,1,0,0,0.000059,0
1111,812D0277,0,3,3,0.714286,0,0,0.004351,0
1112,772D86F5,0,4,4,0.666667,0,0,0.070421,0
1113,7DBB4993,7,0,7,0,0,0.010587,0,0.052884
1114,09978BFE,13,0,13,0,0,0.036174,0,0.152457
1115,7E9D1694,25,0,25,0,0,0.054635,0,0.263615
1116,0B57F8AC,12,2,14,0.6,323.483333,0.000476,0.000068,0.19175
1117,80F7AF5F,7,1,8,1,16,0.00055,0.00009,0.043769
1118,7D35A58A,0,1,1,1,0,0,0.067616,0
1119,7DF2E01F,1,1,2,1,0.5,0.001321,0.000537,0.003635
1120,770B25E5,1,4,5,1,5.533333,0.00466,0.008857,0.005559
1121,7F3CE4A8,0,3,3,0.666667,0,0,0.005439,0
1122,80C2FAE0,4,2,6,0.466667,10.555556,0.007473,0.011108,0.020313
1123,7FA55814,1,1,2,0.666667,2,0,0,0.003635
1124,70598F97,2,0,2,0,0,0.000273,0,0.009195
1125,76F8288D,13,0,13,0,0,0.005176,0,0.089372
1126,7D0DCCE4,2,0,2,0,0,0.002551,0,0.01689
1127,7E2D5937,0,1,1,1,0,0,0.000987,0
1128,7AF2CBCB,2,2,4,1,5,0.000134,0.017565,0.009195
1129,75E2964E,1,0,1,0,0,0.000456,0,0.003635
1130,7A048B8E,1,0,1,0,0,0.00176,0,0.003635
1131,7D5EA34A,0,1,1,1,0,0,0.00342,0
1132,7DBEEF1D,0,1,1,1,0,0,0.017271,0
1133,77838AEC,0,1,1,1,0,0,0.000312,0
1134,810FF5F5,0,1,1,1,0,0,0,0
1135,5D569AF4,1,0,1,0,0,0,0,0.005559
1136,7EFD4A03,1,0,1,0,0,0,0,0.003635
1137,7F13748D,0,4,4,0.548387,0,0,0.02543,0
1138,7D12CCF1,1,0,1,0,0,0,0,0.005559
1139,7C252B83,1,0,1,0,0,0,0,0.005559
1140,80840F9E,2,3,5,0.486486,17.283333,0.006563,0.022965,0.007271
1141,8146C4E0,0,1,1,1,0,0,0.000824,0
1142,6EAEC542,2,0,2,0,0,0.000651,0,0.011622
1143,758297ED,5,2,7,0.5,46,0.00246,0.003241,0.02747
1144,7F9E947A,7,1,8,1,17.5,0.009263,0.001597,0.059517
1145,00811A07,0,2,2,0.533333,0,0,0.000784,0
1146,7D8930DF,2,0,2,0,0,0.001574,0,0.011118
1147,7E5AA4CA,0,2,2,0.555556,0,0,0.004756,0
1148,7FC3CD4C,1,0,1,0,0,0.001085,0,0.006063
1149,80634078,0,1,1,0.314286,0,0,0.000032,0
1150,7DBE63CC,0,1,1,0.666667,0,0,0.005135,0
1151,7D0117DC,0,2,2,0.5,0,0,0.000187,0
1152,792A7152,3,1,4,1,16,0.000465,0.000001,0.03944
1153,7CF447EE,1,0,1,0,0,0.001001,0,0.013758
1154,74CDC404,19,0,19,0,0,0.046495,0,0.343495
1155,804B936F,0,1,1,1,0,0,0.000063,0
1156,8162DDE6,0,3,3,0.375,0,0,0.00441,0
1157,6EE16307,3,1,4,0.571429,2,0.001384,0.001581,0.022999
1158,7A034DF8,0,1,1,0.466667,0,0,0.000094,0
1159,7C3A72D0,2,4,6,0.333333,61,0.00061,0.071033,0.009195
1160,7E243170,3,1,4,1,9,0.000183,0.000441,0.022952
1161,80593BEC,1,0,1,0,0,0.000009,0,0.003635
1162,8115DC89,0,2,2,1,0,0,0,0
1163,801DA721,1,0,1,0,0,0,0,0.003635
1164,8096E3E7,0,3,3,0.37037,0,0,0.073673,0
1165,7EDFBD11,3,0,3,0,0,0.00029,0,0.020525
1166,76084FAE,3,0,3,0,0,0.000002,0,0.010906
1167,7DA48618,1,0,1,0,0,0,0,0.003635
1168,7F52F15A,1,1,2,1,1,0,0,0.003635
1169,6D91F0EA,2,2,4,1,3,0.000002,0,0.007271
1170,7DD85652,1,0,1,0,0,0.000085,0,0.005559
1171,755BCB07,7,0,7,0,0,0.001861,0,0.101172
1172,163D16A8,0,9,9,0.360294,0,0,0.033186,0
1173,7DAD4706,2,0,2,0,0,0.005939,0,0.007271
1174,7CCC6D4F,2,1,3,1,2,0.000147,0.000034,0.007271
1175,044E902A,11,0,11,0,0,0.000642,0,0.113253
1176,7F012065,2,0,2,0,0,0.000028,0,0.025588
1177,84C01098,1,0,1,0,0,0,0,0.003635
1178,7F66027B,4,1,5,1,6.5,0.023855,0.000686,0.047246
1179,811D2600,2,0,2,0,0,0.000017,0,0.007271
1180,80BD743B,0,5,5,0.297872,0,0,0.090668,0
1181,063B51E9,0,1,1,1,0,0,0.004201,0
1182,6E870075,12,2,14,1,76.666667,0.073693,0.020042,0.200693
1183,798F637E,1,0,1,0,0,0.005805,0,0.003635
1184,79FFC689,3,2,5,1,18.583333,0.009537,0.007383,0.030647
1185,7E15F6A8,0,11,11,0.359375,0,0,0.0212,0
1186,77F81AE8,0,1,1,0.666667,0,0,0.000021,0
1187,6C56E0EF,3,0,3,0,0,0.017463,0,0.078161
1188,81670C60,0,4,4,0.333333,0,0,0.004687,0
1189,80B6007E,6,2,8,0.444444,9.833333,0.009774,0.003805,0.034866
1190,7A7A87E2,1,0,1,0,0,0.000601,0,0.003635
1191,7067A072,0,1,1,1,0,0,0.000071,0
1192,7DD7234D,1,0,1,0,0,0.000244,0,0.005559
1193,7DBF71D6,1,0,1,0,0,0.000001,0,0.003635
1194,7D860F40,1,2,3,0.375,60,0.006054,0.006615,0.007986
1195,807077AC,0,2,2,0.322581,0,0,0.000314,0
1196,7F669F7F,19,0,19,0,0,0.049294,0,0.155258
1197,78081613,5,0,5,0,0,0.001102,0,0.03123
1198,5FC7E999,2,0,2,0,0,0.000145,0,0.011118
1199,7FCE6FB9,0,1,1,0.666667,0,0,0.000815,0
1200,5D3E69F5,8,1,9,1,1,0.000245,0.000021,0.06466
1201,5A49C911,3,2,5,0.666667,6,0.001502,0.002051,0.01283
1202,753D4784,4,8,12,0.575758,114.5,0.002839,0.015022,0.020817
1203,7200C7AE,2,0,2,0,0,0.00098,0,0.013042
1204,7E4F1CDC,1,0,1,0,0,0,0,0.003635
1205,76AE261B,0,1,1,1,0,0,0,0
1206,7EC2AEBA,17,4,21,0.413043,353,0.007466,0.011447,0.073848
1207,5B17649D,0,2,2,0.466667,0,0,0.006243,0
1208,79AFB277,0,2,2,0.347826,0,0,0.000138,0
1209,7E937EA5,0,2,2,1,0,0,0.015265,0
1210,5E55A8BD,1,0,1,0,0,0.000039,0,0.003635
1211,7D52D1FC,1,0,1,0,0,0,0,0.005559
1212,7E2C2CE9,2,5,7,0.777778,46,0.000005,0.000947,0.019317
1213,812D1526,0,8,8,0.833333,0,0,0.02981,0
1214,7D2D152C,2,0,2,0,0,0.006281,0,0.012629
1215,5F96C684,1,0,1,0,0,0.000172,0,0.003635
1216,7F6A830C,1,0,1,0,0,0.000755,0,0.003635
1217,78A954C7,0,1,1,0.352941,0,0,0,0
1218,7A977774,2,0,2,0,0,0.016454,0,0.022661
1219,7FEDB133,1,0,1,0,0,0.000236,0,0.006063
1220,771472F7,6,2,8,0.75,335.416667,0.010843,0.004707,0.135323
1221,7B42EC21,1,0,1,0,0,0.001508,0,0.006063
1222,7E9FFB2E,1,1,2,1,1,0.001213,0.067616,0.003635
1223,7EA1EF77,4,11,15,0.484375,106,0.007544,0.022915,0.016465
1224,8172DC20,0,1,1,1,0,0,0.000002,0
1225,7F9F345D,2,0,2,0,0,0.016629,0,0.027012
1226,7F9CCC59,0,1,1,1,0,0,0.067616,0
1227,5D740C8D,7,0,7,0,0,0.00447,0,0.039508
1228,815204C7,1,2,3,0.472222,7,0.000009,0.007053,0.003635
1229,7D9DBF94,0,2,2,0.666667,0,0,0.003432,0
1230,5D6BF570,0,1,1,0.32,0,0,0.000012,0
1231,5F3B80E3,1,0,1,0,0,0.003494,0,0.005559
1232,7F2B42F0,0,2,2,1,0,0,0.018575,0
1233,77BD88B2,1,0,1,0,0,0,0,0.003635
1234,7A5925AC,0,1,1,0.666667,0,0,0.000001,0
1235,7FB7593A,0,2,2,0.75,0,0,0.00397,0
1236,7D3C13A5,1,6,7,0.341317,24.5,0.00318,0.006603,0.003635
1237,7F85793E,2,0,2,0,0,0.000525,0,0.007271
1238,736F33CC,1,0,1,0,0,0.000032,0,0.003635
1239,5E7A2BE1,1,0,1,0,0,0.009279,0,0.023377
1240,0283D89F,0,1,1,1,0,0,0.000181,0
1241,7F2D9D5C,0,3,3,0.355556,0,0,0.001213,0
1242,789E4E37,1,0,1,0,0,0.000917,0,0.003635
1243,802827B3,0,3,3,0.636364,0,0,0.020301,0
1244,7E8EB006,6,3,9,0.8,166.47619,0.01122,0.085724,0.051512
1245,59821969,1,2,3,0.375,60,0.000001,0.000339,0.00849
1246,79E235FF,3,3,6,0.538462,48,0.000017,0.000805,0.02455
1247,7F97C84D,2,1,3,1,3,0.001681,0,0.009195
1248,80212CDD,1,4,5,0.4,11,0.000116,0.003596,0.003635
1249,812A924B,0,1,1,0.261364,0,0,0,0
1250,6DA51A7B,0,12,12,0.459184,0,0,0.02985,0
1251,80BA0708,0,3,3,1,0,0,0.016934,0
1252,7FC34975,0,2,2,0.75,0,0,0.000064,0
1253,7E9D297C,1,3,4,0.461538,12,0.000242,0.003641,0.003635
1254,590BD102,3,0,3,0,0,0.005473,0,0.030987
1255,7D6C5094,0,1,1,1,0,0,0.000128,0
1256,7DC90F9C,0,1,1,1,0,0,0.000065,0
1257,7CFA3EBE,1,2,3,0.284314,0.5,0.000601,0.071605,0.003635
1258,81702C55,3,0,3,0,0,0,0,0.014754
1259,5E16775F,0,2,2,1,0,0,0.000001,0
1260,794AFB8F,1,0,1,0,0,0.000005,0,0.005559
1261,7EB6B65B,0,1,1,1,0,0,0,0
1262,76B15792,5,0,5,0,0,0.002118,0,0.028803
1263,5C5B69BC,0,2,2,1,0,0,0.000373,0
1264,69D7055C,0,1,1,1,0,0,0.000001,0
1265,7CE99366,0,7,7,0.373737,0,0,0.008858,0
1266,814D14F3,1,0,1,0,0,0,0,0.003635
1267,80173038,0,1,1,1,0,0,0.005983,0
1268,78480B8E,1,0,1,0,0,0.000028,0,0.003635
1269,7F9D305C,2,3,5,0.714286,8,0.002117,0.00608,0.007271
1270,80CF200D,1,0,1,0,0,0,0,0.003635
1271,75C463D0,4,1,5,1,4,0.003478,0.013918,0.016465
1272,8054C9C0,0,1,1,1,0,0,0.001439,0
1273,8137E369,0,5,5,0.53125,0,0,0.036293,0
1274,7F010534,24,1,25,1,15.583333,0.047964,0.002737,0.210427
1275,79D676C6,1,2,3,0.473684,1,0.000288,0.005558,0.003635
1276,7EC1D669,0,3,3,1,0,0,0.00004,0
1277,7F38BFBE,0,4,4,0.372727,0,0,0.009422,0
1278,7E57122D,0,2,2,1,0,0,0.014058,0
1279,80710113,2,3,5,1,5.5,0.00718,0.00134,0.007271
1280,807CCE7B,0,2,2,0.36,0,0,0.000007,0
1281,7FE765D3,16,0,16,0,0,0.018709,0,0.084183
1282,805DAA30,0,3,3,0.8,0,0,0.000048,0
1283,7CFC28FA,0,9,9,0.653846,0,0,0.116359,0
1284,7EEBC587,0,1,1,0.666667,0,0,0.000871,0
1285,7E7BA174,1,0,1,0,0,0,0,0.003635
1286,7A5E5F6D,0,8,8,0.652174,0,0,0.000308,0
1287,7EECFCC0,2,0,2,0,0,0.000044,0,0.007271
1288,81A78D93,0,1,1,0.266667,0,0,0,0
1289,8082BB3A,6,3,9,0.4375,84.633333,0.017275,0.006514,0.048923
1290,8145FA2E,0,4,4,0.615385,0,0,0.001815,0
1291,79EE0B9A,0,5,5,0.452381,0,0,0.01248,0
1292,7D33B188,0,6,6,0.275168,0,0,0.042487,0
1293,7FC7F232,5,2,7,1,92.533333,0.000167,0.000055,0.125104
1294,7BBCD195,1,0,1,0,0,0,0,0.003635
1295,746C4E48,3,0,3,0,0,0.001345,0,0.014754
1296,7BD74D7C,1,1,2,0.380952,8,0.000001,0.000005,0.003635
1297,7FCC6228,0,3,3,0.353535,0,0,0.000282,0
1298,758E5A65,6,2,8,0.625,55.522222,0.003289,0.00459,0.067817
1299,7692F68A,0,2,2,0.355932,0,0,0.000578,0
1300,7A08914B,8,0,8,0,0,0.010205,0,0.129057
1301,7891D2F2,0,3,3,0.714286,0,0,0.006483,0
1302,75D4C62A,1,2,3,1,2,0,0.00192,0.003635
1303,80F44105,3,1,4,0.666667,4,0.01102,0.005135,0.010906
1304,78308A48,10,0,10,0,0,0.002078,0,0.108829
1305,7EC21A9A,6,7,13,0.769231,130.166667,0.003464,0.002683,0.034953
1306,7DFE8AE4,0,4,4,0.5,0,0,0.033864,0
1307,7454B475,2,0,2,0,0,0.000732,0,0.013042
1308,80616CB4,1,0,1,0,0,0.00466,0,0.005559
1309,5D6676B8,0,2,2,0.461538,0,0,0.000145,0
1310,7D320CD2,1,0,1,0,0,0.000069,0,0.003635
1311,79677EDE,0,2,2,1,0,0,0.000373,0
1312,762BDDCD,8,6,14,0.538462,444.833333,0.019129,0.008861,0.106743
1313,79DC31CA,1,0,1,0,0,0.000032,0,0.003635
1314,80DBB73F,3,1,4,1,67.166667,0.003953,0.003847,0.105683
1315,762C7302,7,0,7,0,0,0.018265,0,0.044533
1316,7E923534,0,1,1,1,0,0,0.006272,0
1317,816F3B86,0,1,1,1,0,0,0.000019,0
1318,7F025DB5,1,1,2,0.5,4,0.00121,0.000924,0.003635
1319,7F9AEC8C,0,3,3,0.714286,0,0,0.001517,0
1320,7C538B93,1,0,1,0,0,0.000385,0,0.003635
1321,80985997,0,1,1,1,0,0,0.000201,0
1322,5D8BDABB,1,0,1,0,0,0.00005,0,0.003635
1323,7C6F1E26,1,0,1,0,0,0.000102,0,0.003635
1324,5F4A30AE,1,0,1,0,0,0.016102,0,0.019026
1325,7F1B1A79,1,0,1,0,0,0.000644,0,0.007483
1326,7F4BD2C4,0,2,2,1,0,0,0.001633,0
1327,80F6B73A,0,1,1,1,0,0,0.00531,0
1328,7A8CD062,1,0,1,0,0,0,0,0.005559
1329,76577C45,1,0,1,0,0,0.000004,0,0.006063
1330,815D8FB6,2,2,4,1,3.5,0.00734,0.000718,0.007271
1331,7DDB03E8,25,0,25,0,0,0.070201,0,0.251226
1332,7F447498,0,5,5,0.372727,0,0,0.002141,0
1333,800E7ACC,0,1,1,1,0,0,0,0
1334,7F41D3AC,1,3,4,0.5,4,0.004034,0.014754,0.006063
1335,7F376EC3,2,0,2,0,0,0.001129,0,0.007271
1336,7E282140,0,2,2,0.4,0,0,0.000754,0
1337,7D96155C,47,0,47,0,0,0.176675,0,0.348813
1338,8097B005,0,4,4,0.833333,0,0,0.006966,0
1339,7CDEADCA,0,1,1,1,0,0,0.000613,0
1340,58440BE3,0,1,1,1,0,0,0.000046,0
1341,806EBE42,0,1,1,0.392857,0,0,0.000025,0
1342,0CC8E328,0,2,2,0.307692,0,0,0.005407,0
1343,030DD756,1,0,1,0,0,0.000133,0,0.003635
1344,5F9DAE5D,4,0,4,0,0,0.004348,0,0.016465
1345,7EBB6D29,1,1,2,1,1,0.005685,0,0.003635
1346,7D0CCC7A,1,6,7,0.251908,19.333333,0.003494,0.041436,0.005559
1347,81246E89,0,1,1,0.666667,0,0,0.005135,0
1348,7F3E1E31,0,4,4,1,0,0,0.018263,0
1349,7F495543,23,1,24,1,28.833333,0.065757,0.002482,0.277864
1350,76594282,1,0,1,0,0,0,0,0.003635
1351,7EADB818,0,6,6,0.386555,0,0,0.006176,0
1352,7CF49E83,1,1,2,1,0,0.00208,0.00424,0.003635
1353,7D853ABA,0,1,1,0.244186,0,0,0.000054,0
1354,761B5F2A,0,1,1,1,0,0,0,0
1355,78BD4BA7,1,1,2,1,10,0.000471,0.000002,0.008187
1356,5B8B0E80,5,0,5,0,0,0.003048,0,0.027796
1357,776B3F37,3,1,4,0.424242,98.833333,0.010241,0.005047,0.030647
1358,7DE589C8,4,0,4,0,0,0.002578,0,0.122216
1359,6FF3092D,8,0,8,0,0,0.032517,0,0.119145
1360,7EAB13AC,0,3,3,0.4,0,0,0.010349,0
1361,77ADB830,0,1,1,0.282051,0,0,0.000026,0
1362,7DAE3673,0,1,1,0.242991,0,0,0.000049,0
1363,7F26860F,0,1,1,1,0,0,0.067616,0
1364,7E7C83FB,2,2,4,0.393443,47,0.000021,0.005181,0.007271
1365,7EAF124B,5,0,5,0,0,0.007971,0,0.056977
1366,7D9579A8,1,3,4,0.362832,1,0.000526,0.000439,0.003635
1367,78EF8770,1,0,1,0,0,0.004983,0,0.009407
1368,7EDD8536,1,0,1,0,0,0.000736,0,0.003635
1369,7E56A449,2,2,4,0.333333,29.5,0.000217,0.002469,0.007271
1370,7EE2A5FA,1,1,2,1,1,0,0.000488,0.003635
1371,7B91023A,0,2,2,0.255924,0,0,0.004098,0
1372,5F66AC38,0,2,2,0.413793,0,0,0.000073,0
1373,7F9CB2ED,1,4,5,0.318182,28,0,0.069711,0.003635
1374,773F990C,1,1,2,1,0.333333,0.000378,0.000906,0.003635
1375,7DE9FCD7,1,2,3,1,16,0.009279,0.00018,0.023377
1376,7CF3D2F1,0,3,3,0.4,0,0,0.008829,0
1377,7DD59732,1,3,4,0.6,5,0.000595,0.021051,0.003635
1378,810CA474,0,1,1,1,0,0,0.00531,0
1379,7FA5C823,0,10,10,0.414894,0,0,0.034145,0
1380,8032545E,0,2,2,0.75,0,0,0.006363,0
1381,81641E42,0,4,4,0.6,0,0,0.000363,0
1382,76C4C6D9,2,0,2,0,0,0.000535,0,0.018668
1383,7BF96E76,0,2,2,1,0,0,0.015726,0
1384,7ED1B792,0,5,5,0.611111,0,0,0.000288,0
1385,7ED43F00,0,1,1,1,0,0,0.000048,0
1386,7FBC7AA0,0,2,2,0.75,0,0,0.003767,0
1387,7DFD4543,1,0,1,0,0,0.000469,0,0.007852
1388,7F89DDA6,1,0,1,0,0,0.000001,0,0.003635
1389,7DC9D4C4,2,0,2,0,0,0.000017,0,0.013393
1390,7B5B74A1,0,1,1,0.666667,0,0,0.000029,0
1391,81551C13,2,3,5,0.359375,44,0.000838,0.005991,0.007271
1392,7A65416D,3,0,3,0,0,0.009432,0,0.010906
1393,75C5A049,0,1,1,1,0,0,0.067616,0
1394,7DBA1B7B,6,9,15,0.846154,73.833333,0.021241,0.043964,0.02566
1395,7FEC6C87,1,0,1,0,0,0,0,0.003635
1396,7E0E89EE,0,2,2,0.466667,0,0,0.027653,0
1397,7F9D0969,0,2,2,0.473684,0,0,0.012992,0
1398,593FF0E7,3,0,3,0,0,0.01107,0,0.036922
1399,79FB1E8F,1,0,1,0,0,0,0,0.003635
1400,7F88D9F2,0,2,2,1,0,0,0.001195,0
1401,7748EA34,0,2,2,1,0,0,0.068735,0
1402,80D4CD1C,0,5,5,0.727273,0,0,0.002378,0
1403,6F2A3A40,8,0,8,0,0,0.007789,0,0.031007
1404,5DA7459E,1,0,1,0,0,0.002464,0,0.007921
1405,81796F47,0,1,1,1,0,0,0,0
1406,817793D0,0,1,1,0.666667,0,0,0,0
1407,7F5F852D,2,1,3,0.470588,14.5,0.000024,0,0.009195
1408,7E708120,3,0,3,0,0,0.004701,0,0.017775
1409,7EFD0BB9,0,3,3,0.375,0,0,0.003361,0
1410,7D3EC453,1,2,3,0.555556,4,0.000408,0.000021,0.003635
1411,58352CFA,1,1,2,1,1,0.005926,0.002723,0.003635
1412,5DA94864,0,2,2,0.384615,0,0,0.006654,0
1413,7EA9B9D9,2,2,4,0.666667,4,0.00662,0.002941,0.007271
1414,80D4733F,0,1,1,0.666667,0,0,0.000495,0
1415,7F274EEF,3,3,6,0.5,49.5,0.001571,0.005631,0.017181
1416,7DC2FCA0,2,0,2,0,0,0.000002,0,0.009195
1417,7D06C793,2,1,3,0.666667,4,0.000118,0.000806,0.007271
1418,5964E392,2,0,2,0,0,0,0,0.009195
1419,7FA7D3EB,1,1,2,0.333333,0,0.000175,0.002041,0.003635
1420,7FA148D2,3,0,3,0,0,0.002955,0,0.149192
1421,7FD918C6,0,1,1,1,0,0,0.000092,0
1422,6A1445D2,0,3,3,1,0,0,0.000194,0
1423,7DC897B2,1,2,3,0.75,3,0.000044,0.004376,0.003635
1424,7572B464,0,4,4,0.309904,0,0,0.00801,0
1425,7E73762E,0,2,2,0.470588,0,0,0.006147,0
1426,783A48EC,1,0,1,0,0,0.001164,0,0.003635
1427,7DD7E477,0,1,1,0.666667,0,0,0.000815,0
1428,7F108B08,1,3,4,0.454545,12,0.000018,0.08772,0.003635
1429,77349122,0,1,1,1,0,0,0,0
1430,81613A60,0,2,2,0.75,0,0,0.020154,0
1431,804CDE16,0,5,5,0.529412,0,0,0.005175,0
1432,7951E715,1,2,3,1,2.333333,0.000244,0.0698,0.005559
1433,76C22CB6,1,4,5,1,2,0.006002,0.070558,0.003635
1434,7FCD235E,0,12,12,0.410811,0,0,0.012158,0
1435,7D08A66B,13,0,13,0,0,0.05928,0,0.119892
1436,80AA8562,0,5,5,0.4,0,0,0.013641,0
1437,7D7D8306,1,3,4,0.361905,2,0.000081,0.002378,0.003635
1438,7DB58880,0,3,3,0.254438,0,0,0.069866,0
1439,7D6DEB86,0,1,1,0.314516,0,0,0.001284,0
1440,756C1A6E,0,10,10,0.348199,0,0,0.008534,0
1441,8044AE26,0,4,4,0.636364,0,0,0.011591,0
1442,5F881077,1,0,1,0,0,0,0,0.003635
1443,7FED0683,2,0,2,0,0,0.000407,0,0.007271
1444,81741F4C,0,3,3,0.349315,0,0,0.001878,0
1445,7C6CB221,0,1,1,1,0,0,0.000002,0
1446,76C5E7FF,2,0,2,0,0,0.005284,0,0.009195
1447,7B272C88,1,0,1,0,0,0.000367,0,0.003635
1448,7DBBF15D,0,3,3,0.4,0,0,0.011052,0
1449,80BA6FD9,0,1,1,1,0,0,0.000043,0
1450,7EFE7EAF,1,0,1,0,0,0,0,0.005559
1451,80952A2A,0,1,1,1,0,0,0,0
1452,8137E6B7,1,2,3,1,1.5,0.000408,0.01742,0.003635
1453,7E0A26B3,0,1,1,1,0,0,0,0
1454,79250463,2,5,7,0.32,49.25,0.002331,0.0088,0.009195
1455,7A3600BF,1,0,1,0,0,0.001213,0,0.003635
1456,7EB22B0A,0,1,1,1,0,0,0.001398,0
1457,6D2165A8,32,0,32,0,0,0.055978,0,0.24788
1458,79C93005,0,2,2,0.288462,0,0,0.00425,0
1459,7BCD4EB8,2,2,4,0.366667,21.5,0.001193,0.000322,0.016241
1460,79E211A8,0,1,1,0.411765,0,0,0.000041,0
1461,5478B992,0,4,4,0.383721,0,0,0.000009,0
1462,78BD481E,1,0,1,0,0,0.00318,0,0.003635
1463,7785E2DD,0,1,1,0.444444,0,0,0.000732,0
1464,7DC75EAA,1,0,1,0,0,0.000023,0,0.003635
1465,7ECD38FC,0,1,1,0.666667,0,0,0.003336,0
1466,7F261727,1,3,4,1,2.5,0.007602,0.019126,0.003635
1467,7937485A,3,1,4,1,7.5,0.009417,0.00342,0.037693
1468,810EA2F0,2,2,4,1,2.5,0.003743,0.019713,0.009195
1469,781A3E2C,0,1,1,0.448276,0,0,0.013735,0
1470,7EE33847,1,7,8,0.5,17,0,0.00017,0.003635
1471,714EA8CE,1,0,1,0,0,0,0,0.005559
1472,778AABDC,1,0,1,0,0,0,0,0.003635
1473,77CEBA1B,6,0,6,0,0,0.027368,0,0.036286
1474,802F7931,0,1,1,0.666667,0,0,0,0
1475,7CACDE28,1,0,1,0,0,0,0,0.003635
1476,7E494C62,1,0,1,0,0,0.001134,0,0.003635
1477,05A98ECF,1,0,1,0,0,0.000544,0,0.005559
1478,80672D77,2,0,2,0,0,0.001688,0,0.016563
1479,8159CA04,0,1,1,0.666667,0,0,0.000072,0
1480,8152CAB9,1,1,2,1,0,0.000632,0.000097,0.003635
1481,80155C11,1,1,2,1,1,0,0,0.003635
1482,7802F9F0,0,3,3,0.318182,0,0,0.005447,0
1483,7CAC0C68,0,1,1,1,0,0,0,0
1484,7F46CAD6,2,0,2,0,0,0.006475,0,0.007271
1485,7FD24901,0,1,1,0.5,0,0,0,0
1486,7C066981,2,0,2,0,0,0.006144,0,0.007271
1487,7A96023B,1,2,3,1,2,0,0,0.003635
1488,0BDC5862,1,0,1,0,0,0,0,0.003635
1489,806CAFF8,1,2,3,1,2,0.000135,0.000023,0.003635
1490,81630C60,0,1,1,0.345794,0,0,0.000948,0
1491,7D95918C,1,3,4,0.478261,13,0,0.004449,0.005559
1492,7DBB1FB9,0,1,1,0.345794,0,0,0.000948,0
1493,6D23C36A,1,0,1,0,0,0,0,0.005559
1494,7FDADF29,0,1,1,1,0,0,0.001731,0
1495,7F1D0EAF,0,1,1,1,0,0,0.000312,0
1496,793C2353,0,6,6,0.875,0,0,0.006777,0
1497,81092CCE,6,0,6,0,0,0.000245,0,0.274489
1498,80B0F04C,0,1,1,1,0,0,0.000824,0
1499,6F97AE10,1,0,1,0,0,0.001134,0,0.003635
1500,7EA6F036,5,3,8,1,26,0.015908,0.087658,0.034574
1501,7B5DE76D,0,2,2,1,0,0,0.005221,0
1502,7DB65373,1,14,15,0.4,64,0.000049,0.127798,0.003635
1503,80EA9469,0,5,5,0.518519,0,0,0.019418,0
1504,7E305BD7,8,1,9,1,11,0.009455,0.000134,0.037282
1505,7E03F6EF,1,8,9,0.390909,79,0.00075,0.014281,0.007986
1506,7E6AD0D8,5,1,6,1,8,0.003133,0.006272,0.036601
1507,7ED335AE,16,0,16,0,0,0.052724,0,0.102869
1508,75ED319F,1,8,9,0.398305,46,0.00631,0.076423,0.003635
1509,7E60E536,0,4,4,0.482143,0,0,0.016376,0
1510,7E01B4CD,13,0,13,0,0,0.047694,0,0.151087
1511,808F423C,1,6,7,0.8,0,0.002939,0.034235,0.003635
1512,80F233CC,0,1,1,1,0,0,0.001585,0
1513,80B7F6AF,1,6,7,0.4375,5,0.005685,0.004664,0.003635
1514,5F4888F0,1,0,1,0,0,0,0,0.005559
1515,80218377,2,10,12,0.428571,14,0.013144,0.085143,0.007271
1516,80867B53,1,0,1,0,0,0.00067,0,0.003635
1517,76C4E628,1,0,1,0,0,0,0,0.00991
1518,7B0F88E2,1,0,1,0,0,0.003747,0,0.016185
1519,7C2AD11F,1,4,5,0.615385,8,0,0.000404,0.003635
1520,5E27EE9D,1,1,2,1,1,0.000262,0.004826,0.003635
1521,78808E91,0,4,4,0.4,0,0,0.010474,0
1522,03CF3783,1,0,1,0,0,0.000151,0,0.025155
1523,8013F912,1,0,1,0,0,0.006924,0,0.003635
1524,7F02AA54,0,2,2,0.333333,0,0,0.00001,0
1525,7CDE5DCC,0,3,3,0.8,0,0,0.003594,0
1526,75D2EB80,2,9,11,0.681818,8.733333,0.000799,0.003413,0.007271
1527,7E8E19C7,1,0,1,0,0,0.000025,0,0.003635
1528,77045C02,1,0,1,0,0,0.000882,0,0.080354
1529,7A2E21F0,0,1,1,1,0,0,0,0
1530,7F012F34,1,0,1,0,0,0.000155,0,0.003635
1531,81697CCA,1,1,2,1,0,0.00147,0.000251,0.003635
1532,8139DDED,4,0,4,0,0,0.002886,0,0.089515
1533,0B5368BD,2,0,2,0,0,0.000016,0,0.018991
1534,7B371FB1,0,5,5,0.484848,0,0,0.004387,0
1535,660CEC87,0,2,2,0.458333,0,0,0.004852,0
1536,7F6F64A3,7,5,12,0.6,168.322222,0.021413,0.002408,0.069672
1537,78DEBFA0,0,13,13,0.457143,0,0,0.087518,0
1538,812A382D,25,2,27,0.75,212.666667,0.128722,0.002521,0.189956
1539,5FA828FA,4,1,5,1,0.333333,0.006473,0.004656,0.028185
1540,5F971C88,7,0,7,0,0,0.019682,0,0.05096
1541,817904DE,0,5,5,0.391753,0,0,0.002093,0
1542,5F717F9A,2,0,2,0,0,0.001454,0,0.007271
1543,5D871860,2,0,2,0,0,0,0,0.011622
1544,75B1D07F,1,0,1,0,0,0,0,0.003635
1545,7CB6CAA8,0,1,1,0.5,0,0,0.000345,0
1546,590A8D05,0,4,4,0.666667,0,0,0.009995,0
1547,7DE67AE3,0,1,1,0.6,0,0,0,0
1548,5C048F0D,1,6,7,1,6,0,0.00139,0.003635
1549,776EC6DE,1,0,1,0,0,0.000005,0,0.003635
1550,7FAAA2F2,1,5,6,0.423077,43,0,0.027382,0.005559
1551,8027E5FF,0,4,4,0.833333,0,0,0.004596,0
1552,59E4D84C,1,3,4,1,3.5,0.000717,0.075454,0.005559
1553,7ED0B30D,0,2,2,0.75,0,0,0.001186,0
1554,7ED4B960,0,5,5,0.330709,0,0,0.041782,0
1555,7563A392,0,3,3,0.404762,0,0,0.007277,0
1556,04199118,1,0,1,0,0,0,0,0.003635
1557,7D0E539A,4,5,9,1,20.5,0.011648,0.005306,0.016465
1558,0260EE25,2,0,2,0,0,0,0,0.025385
1559,7D335FFC,0,4,4,0.354167,0,0,0.003977,0
1560,78250307,1,0,1,0,0,0.01,0,0.023554
1561,76A57C39,0,1,1,1,0,0,0.000261,0
1562,7D2109D6,0,1,1,1,0,0,0,0
1563,7E552161,0,1,1,1,0,0,0.001594,0
1564,7E86342C,2,0,2,0,0,0.001193,0,0.016241
1565,752D76AE,1,0,1,0,0,0.003559,0,0.005559
1566,7F099881,1,2,3,0.396226,40,0.001478,0.004402,0.005559
1567,5F54B73B,1,0,1,0,0,0.000385,0,0.003635
1568,5BEB5C6C,1,0,1,0,0,0.006984,0,0.003635
1569,77EDC932,0,1,1,0.6,0,0,0.002797,0
1570,80FB4CEA,4,0,4,0,0,0.002945,0,0.156675
1571,7E1119E4,0,2,2,1,0,0,0.000032,0
1572,76D2B21C,2,0,2,0,0,0.016364,0,0.022661
1573,760A9578,5,0,5,0,0,0.025117,0,0.067933
1574,800D216C,0,3,3,1,0,0,0.004359,0
1575,81355019,0,3,3,0.343434,0,0,0.000297,0
1576,7E964867,1,2,3,0.6,1,0.000025,0.000396,0.003635
1577,598CFBBF,3,0,3,0,0,0.019893,0,0.050243
1578,7D913998,4,1,5,0.409091,34,0.000117,0.0003,0.014542
1579,7FDB47DB,6,0,6,0,0,0.023134,0,0.044749
1580,7E49F284,0,2,2,0.407407,0,0,0.015013,0
1581,8077D440,0,1,1,1,0,0,0.003126,0
1582,5E3316C2,1,0,1,0,0,0.000991,0,0.003635
1583,7EFDED93,2,0,2,0,0,0.003052,0,0.007271
1584,750E4249,2,2,4,0.297297,107,0.000472,0.000041,0.011487
1585,0C49CC7B,15,0,15,0,0,0.013341,0,0.182178
1586,79EC7542,0,2,2,0.666667,0,0,0,0
1587,78033E8F,1,0,1,0,0,0,0,0.017366
1588,5F289DB1,0,2,2,0.392157,0,0,0.004939,0
1589,7E6653CA,0,3,3,0.533333,0,0,0.072723,0
1590,788BBDE2,2,0,2,0,0,0.00132,0,0.007271
1591,76B0F763,3,1,4,1,7,0.000743,0.000233,0.017181
1592,7CCB6BBE,3,0,3,0,0,0.006176,0,0.020525
1593,7780F007,2,0,2,0,0,0.000506,0,0.007271
1594,7F678912,0,5,5,0.283019,0,0,0.017214,0
1595,7731966E,3,0,3,0,0,0.000816,0,0.010906
1596,7A01E667,2,3,5,0.8,8,0.000174,0.000105,0.05059
1597,792825A7,1,6,7,0.75,8,0.005805,0.088117,0.003635
1598,752E103A,1,0,1,0,0,0.000004,0,0.003635
1599,7E29DC9F,31,1,32,1,65.666667,0.060253,0.006272,0.238374
1600,798AFD2C,0,2,2,1,0,0,0.004125,0
1601,8178DDCB,1,5,6,0.466667,7.866667,0.000018,0.000229,0.003635
1602,7F7147D6,0,1,1,0.461538,0,0,0.00018,0
1603,5B75C743,0,3,3,0.714286,0,0,0.003429,0
1604,7D89D529,0,6,6,0.5,0,0,0.008158,0
1605,7FEBDE34,1,3,4,1,3,0.001239,0.001256,0.003635
1606,7CA87CB8,0,1,1,0.304897,0,0,0.000433,0
1607,7D7437B8,0,5,5,0.376147,0,0,0.010765,0
1608,794DA730,0,2,2,1,0,0,0,0
1609,7D30351C,0,1,1,0.6,0,0,0,0
1610,811D6B75,1,1,2,0.37037,23.5,0,0.005604,0.00991
1611,7D940D89,2,1,3,1,2,0.001493,0,0.007271
1612,804C82B5,0,1,1,1,0,0,0.000027,0
1613,81403269,7,3,10,0.583333,88,0.017276,0.07946,0.039418
1614,7F45F447,2,1,3,1,1,0.000686,0.006272,0.029115
1615,80654BD9,4,0,4,0,0,0.002238,0,0.044782
1616,78AD7B9C,5,7,12,0.769231,45.916667,0.012499,0.023565,0.027796
1617,7A84421F,2,0,2,0,0,0.005727,0,0.007271
1618,811275EA,0,1,1,1,0,0,0.000636,0
1619,80B70CAB,1,2,3,0.75,3,0,0.007443,0.007986
1620,7C5BB1F7,0,1,1,1,0,0,0.000207,0
1621,7F16B5B3,0,7,7,0.478261,0,0,0.099927,0
1622,7F53A308,0,1,1,1,0,0,0.00008,0
1623,800A731C,0,5,5,0.512821,0,0,0.100491,0
1624,7CD98760,1,1,2,0.428571,12,0.000927,0.006056,0.005559
1625,7566B56D,5,0,5,0,0,0.002425,0,0.020101
1626,7FD93F27,13,3,16,0.571429,118,0.012872,0.009988,0.056879
1627,7C7AD787,1,1,2,1,3,0.000506,0.000035,0.007483
1628,7E5B38CF,1,2,3,0.625,5,0,0.000797,0.003635
1629,7F875DF2,2,1,3,1,2,0.000336,0.00087,0.007271
1630,7D2B8036,5,4,9,0.833333,45,0.001228,0.008682,0.034574
1631,7F5D7C8D,2,0,2,0,0,0.001382,0,0.007271
1632,8138C0CD,0,2,2,0.351852,0,0,0.001242,0
1633,7FFEB703,2,0,2,0,0,0.001656,0,0.007271
1634,7D8865B9,0,1,1,1,0,0,0.00531,0
1635,7B383056,1,0,1,0,0,0,0,0.003635
1636,58C68905,0,1,1,1,0,0,0,0
1637,7DC885A6,1,0,1,0,0,0,0,0.003635
1638,75E72EBD,0,1,1,0.391304,0,0,0.001097,0
1639,812D46A3,2,2,4,0.466667,15,0.001611,0.028791,0.007271
1640,5A156D78,0,2,2,0.416667,0,0,0.001538,0
1641,80D7907C,1,1,2,1,0.5,0.000482,0.001701,0.003635
1642,71600E86,0,4,4,1,0,0,0.013107,0
1643,5BA0687C,5,0,5,0,0,0.00042,0,0.025872
1644,75941F8D,2,0,2,0,0,0.014965,0,0.027012
1645,5EF7D983,0,1,1,1,0,0,0.000021,0
1646,763D4F8E,1,0,1,0,0,0,0,0.003635
1647,7FDB3B00,0,1,1,0.328358,0,0,0,0
1648,80843370,11,3,14,0.473684,50.059524,0.038097,0.012596,0.154152
1649,7FEA06E4,2,0,2,0,0,0.002189,0,0.007271
1650,80F50677,2,1,3,1,3,0.000063,0,0.011622
1651,80A72EFD,0,1,1,1,0,0,0.000613,0
1652,7550F29B,0,5,5,0.353535,0,0,0.000088,0
1653,7E47C03F,1,4,5,0.833333,25,0.000596,0.000398,0.008994
1654,8123596B,1,3,4,0.333333,90.5,0.016102,0.008898,0.019026
1655,5DB0A752,2,0,2,0,0,0,0,0.007271
1656,7D481D29,0,5,5,0.514286,0,0,0.039975,0
1657,7A68659E,1,0,1,0,0,0.000107,0,0.005559
1658,7DDF11E8,0,2,2,0.466667,0,0,0.000137,0
1659,76752455,2,3,5,0.8,8,0.000262,0.005938,0.007271
1660,7E0E719C,0,5,5,0.381818,0,0,0.007105,0
1661,7902717F,6,0,6,0,0,0.022734,0,0.051263
1662,7D009D18,1,5,6,0.338462,22,0,0.005638,0.003635
1663,757A42AD,6,0,6,0,0,0.018985,0,0.043477
1664,767861AD,0,3,3,0.274194,0,0,0.00089,0
1665,7B57BCEA,1,0,1,0,0,0.000135,0,0.003635
1666,79E77860,3,1,4,0.318182,165,0.000007,0,0.018046
1667,8158CAEE,2,4,6,0.833333,6.583333,0.000497,0.008594,0.009195
1668,757BA39E,10,0,10,0,0,0.004104,0,0.103996
1669,7F08BAA0,1,3,4,0.473684,8,0.000306,0.007532,0.005559
1670,780D9349,1,1,2,0.44,22,0.001786,0,0.005559
1671,7CD7CACC,0,1,1,0.6,0,0,0.000141,0
1672,78813073,0,2,2,0.47619,0,0,0.068111,0
1673,7CD6D412,0,6,6,0.390909,0,0,0.016276,0
1674,7DDC6C4D,8,0,8,0,0,0.000404,0,0.279294
1675,6D221BE0,2,4,6,0.75,6.666667,0.000815,0.009165,0.007271
1676,7E9D14A2,0,6,6,0.34375,0,0,0.014733,0
1677,58F283C4,0,1,1,1,0,0,0.001549,0
1678,816738C7,19,0,19,0,0,0.003442,0,0.104653
1679,81022BF6,0,2,2,1,0,0,0.001679,0
1680,750C3788,1,0,1,0,0,0,0,0.007483
1681,7E8CF889,0,2,2,1,0,0,0.028975,0
1682,7EFAE753,1,2,3,0.434783,2,0.001064,0.00153,0.003635
1683,78FA1A36,5,0,5,0,0,0.011092,0,0.037918
1684,7DA33657,0,1,1,0.5,0,0,0.00296,0
1685,80A4C873,0,3,3,0.402985,0,0,0.008926,0
1686,7E37E7E0,0,2,2,1,0,0,0.001296,0
1687,7DC9981B,1,3,4,0.325397,39,0.000059,0.001968,0.003635
1688,81542D5D,2,0,2,0,0,0.000216,0,0.007271
1689,7FAFE041,19,8,27,0.378378,758.333333,0.046811,0.105625,0.093933
1690,811346EA,2,0,2,0,0,0.000119,0,0.009195
1691,03BCDE66,0,1,1,1,0,0,0.067616,0
1692,810790F2,0,2,2,0.362319,0,0,0,0
1693,7F03A179,0,7,7,0.388889,0,0,0.006543,0
1694,77DEF46B,3,0,3,0,0,0.000794,0,0.064345
1695,7E747208,1,0,1,0,0,0.000001,0,0.003635
1696,7EDFE07D,0,2,2,0.359223,0,0,0.001691,0
1697,8083F56C,0,1,1,0.666667,0,0,0.000046,0
1698,80010EC6,3,4,7,1,221,0.000701,0.006529,0.082031
1699,7FC6B134,1,5,6,0.513514,18,0.001195,0.050802,0.003635
1700,7E04FB66,0,1,1,0.30303,0,0,0.000636,0
1701,8000834A,0,1,1,1,0,0,0.000098,0
1702,7FD5CDD2,0,1,1,1,0,0,0,0
1703,7F32DEE6,0,1,1,1,0,0,0,0
1704,7FFBC6F8,0,1,1,1,0,0,0,0
1705,7EC1FC53,0,1,1,1,0,0,0.003962,0
1706,7FDA3EA9,0,4,4,0.833333,0,0,0.010569,0
1707,7AFE0B69,5,0,5,0,0,0.006304,0,0.025872
1708,7DF6CA6B,1,1,2,1,1,0.000558,0.003962,0.003635
1709,815F1F2A,7,4,11,0.29,295,0.031692,0.10058,0.039921
1710,7F807629,1,0,1,0,0,0.000018,0,0.003635
1711,7B92870A,3,3,6,0.5,50,0.001985,0.007205,0.019105
1712,7726AE33,3,0,3,0,0,0.011052,0,0.01283
1713,7EB217A7,0,3,3,0.636364,0,0,0.021358,0
1714,7EC03C6F,1,1,2,1,1,0.000447,0.000925,0.003635
1715,79E863E9,0,1,1,0.666667,0,0,0.003336,0
1716,59543725,1,0,1,0,0,0.000991,0,0.003635
1717,7D87C144,2,1,3,1,1,0.008801,0.000233,0.011118
1718,6C80D310,2,0,2,0,0,0.003176,0,0.007271
1719,7B76CD90,1,4,5,0.666667,8,0,0.005991,0.003635
1720,777040F2,0,1,1,1,0,0,0,0
1721,665B190C,0,1,1,1,0,0,0,0
1722,79A12351,0,1,1,0.666667,0,0,0,0
1723,7F18B6FA,14,4,18,0.75,173.37619,0.043909,0.093964,0.135421
1724,7C9317F5,0,2,2,0.4375,0,0,0.072663,0
1725,7F9A61FB,0,1,1,1,0,0,0.000055,0
1726,8149D469,0,4,4,0.479167,0,0,0.015111,0
1727,7B0C185A,1,0,1,0,0,0.005685,0,0.003635
1728,7E66E7D2,0,2,2,0.351852,0,0,0.001242,0
1729,79BC3BB8,5,12,17,0.875,59.666667,0.001929,0.000707,0.020101
1730,5BDCDF52,6,0,6,0,0,0.020315,0,0.068574
1731,805878CD,2,3,5,0.37037,11.166667,0,0.001114,0.009195
1732,7EBA6C6A,1,0,1,0,0,0.000563,0,0.005559
1733,80EF2E7A,2,2,4,1,4,0.006046,0.014024,0.009195
1734,79D01A30,14,0,14,0,0,0.010632,0,0.099674
1735,80D67F3D,0,2,2,1,0,0,0.001387,0
1736,03A7AFD7,0,2,2,1,0,0,0.000045,0
1737,754DA328,6,0,6,0,0,0.000191,0,0.033859
1738,7983C12E,1,0,1,0,0,0.001782,0,0.003635
1739,72A21AFE,9,0,9,0,0,0.012064,0,0.037573
1740,7C87E046,3,0,3,0,0,0.000385,0,0.016678
1741,5C1FA007,0,2,2,0.666667,0,0,0.068827,0
1742,7E0CB8E0,1,2,3,0.5,4.5,0.005685,0.000231,0.003635
1743,59F43B93,0,1,1,0.4,0,0,0,0
1744,7E45CE23,0,4,4,0.482759,0,0,0.001077,0
1745,7B0C53DA,1,13,14,0.58,6,0.003301,0.04176,0.003635
1746,7F15B174,3,1,4,0.289474,17.5,0.007027,0,0.01283
1747,7769AAA0,2,0,2,0,0,0.000073,0,0.007271
1748,7E6E912B,5,2,7,0.625,7.333333,0.018929,0.003312,0.049507
1749,84465E59,9,0,9,0,0,0.000545,0,0.040414
1750,7C6F9234,0,6,6,0.324717,0,0,0.008205,0
1751,5FDD5B1D,0,3,3,0.5,0,0,0.000326,0
1752,8009BE2A,1,1,2,1,1,0,0,0.003635
1753,5DEB7243,2,0,2,0,0,0.00076,0,0.011622
1754,80A3D245,1,0,1,0,0,0.000018,0,0.003635
1755,75E0080C,1,0,1,0,0,0.000005,0,0.003635
1756,7A56F737,2,0,2,0,0,0.000927,0,0.011118
1757,7F6A5750,2,0,2,0,0,0.016334,0,0.032736
1758,7E91DF42,9,1,10,1,13,0.000609,0.000441,0.046276
1759,7DC06CA1,1,6,7,0.262626,8.416667,0.00208,0.01448,0.003635
1760,80602008,0,3,3,0.571429,0,0,0.000291,0
1761,807DFA8C,0,1,1,0.37037,0,0,0.005604,0
1762,8170C344,0,1,1,0.345794,0,0,0.000948,0
1763,78C94E25,0,3,3,1,0,0,0.005509,0
1764,7D339067,0,3,3,1,0,0,0.017525,0
1765,7EE607F4,0,2,2,1,0,0,0,0
1766,7D0758F1,0,1,1,0.345794,0,0,0.000948,0
1767,7BD24CB1,3,0,3,0,0,0.010309,0,0.020525
1768,80A81B26,0,2,2,0.351852,0,0,0.001242,0
1769,7D0C2FDF,0,2,2,0.444444,0,0,0.003659,0
1770,79B00E8D,3,2,5,0.317073,89.333333,0.013321,0.0689,0.010906
1771,5CBAC419,1,1,2,0.369565,34,0.000001,0.001428,0.003635
1772,80CCE34F,4,0,4,0,0,0.010034,0,0.047604
1773,79BE6EDE,1,0,1,0,0,0.001064,0,0.003635
1774,7BF6386C,0,2,2,1,0,0,0.005349,0
1775,7EEA166E,0,6,6,0.421053,0,0,0.000443,0
1776,7DFA8300,6,0,6,0,0,0.010211,0,0.031935
1777,7D661F58,5,6,11,0.527778,50.833333,0.009103,0.050889,0.023948
1778,7FAC1B59,3,1,4,1,3,0.001661,0,0.010906
1779,78A526D4,3,1,4,1,3,0.001131,0.000004,0.010906
1780,7A5FF7BF,1,0,1,0,0,0,0,0.003635
1781,80043CDC,0,1,1,0.314286,0,0,0,0
1782,7FCDF748,1,1,2,1,1,0,0.000382,0.003635
1783,7F6B8CAC,1,7,8,0.888889,8,0,0.008146,0.003635
1784,7B670CBA,1,0,1,0,0,0.00466,0,0.005559
1785,76C0ED69,0,1,1,1,0,0,0.000159,0
1786,58C76F8B,3,1,4,0.571429,5.7,0.000169,0.000054,0.052302
1787,7D30089B,0,1,1,1,0,0,0.000058,0
1788,7D0AD5A4,0,1,1,0.242991,0,0,0.000049,0
1789,7DED516A,0,1,1,1,0,0,0.000117,0
1790,7AB50F13,1,0,1,0,0,0.000025,0,0.003635
1791,59429E5D,2,0,2,0,0,0.009419,0,0.027012
1792,81451E2B,0,2,2,0.666667,0,0,0.009655,0
1793,80D69E67,0,3,3,0.8,0,0,0.005138,0
1794,858AEF97,2,0,2,0,0,0.000684,0,0.007271
1795,5FA1BA21,0,1,1,1,0,0,0.000003,0
1796,02633048,0,1,1,1,0,0,0.003083,0
1797,7AA55B9E,1,0,1,0,0,0.001288,0,0.003635
1798,7A1D8890,0,1,1,1,0,0,0.000401,0
1799,802C4D3B,12,3,15,0.8,85.5,0.034738,0.003721,0.072482
1800,80F1E1CC,5,0,5,0,0,0.016152,0,0.026376
1801,7FA9EDD1,1,1,2,0.354839,13,0,0.000252,0.007986
1802,7E6D7693,1,0,1,0,0,0.000007,0,0.005559
1803,805A83AD,1,1,2,1,2,0.000373,0.000013,0.005559
1804,7D38A626,0,2,2,0.625,0,0,0.004995,0
1805,79F9481B,0,4,4,0.34375,0,0,0.0021,0
1806,7B77D4E9,0,1,1,0.666667,0,0,0,0
1807,774D3BDE,1,0,1,0,0,0.000378,0,0.003635
1808,5AEFE38A,1,0,1,0,0,0.000017,0,0.005559
1809,7EC60ED9,1,0,1,0,0,0.000736,0,0.003635
1810,800E1E41,14,0,14,0,0,0.019955,0,0.101268
1811,800E182A,1,1,2,1,0,0.000017,0.000001,0.00707
1812,785367F1,1,0,1,0,0,0.000085,0,0.003635
1813,7721C0E9,0,6,6,0.30719,0,0,0.001002,0
1814,7D5C5B53,0,2,2,0.75,0,0,0.000836,0
1815,7E7CE211,0,4,4,0.314286,0,0,0.005679,0
1816,800BF389,0,5,5,0.393939,0,0,0.008884,0
1817,7FA33BC1,0,1,1,1,0,0,0.001972,0
1818,7F41CFE1,0,1,1,1,0,0,0.000542,0
1819,7F606E5B,8,0,8,0,0,0.031855,0,0.089357
1820,788E953E,1,4,5,0.75,6,0,0.006387,0.003635
1821,7662F6B2,0,2,2,0.428571,0,0,0.001115,0
1822,78E8D7B6,1,0,1,0,0,0.008229,0,0.003635
1823,7F5F5160,3,0,3,0,0,0.000816,0,0.018692
1824,7FEB9B3C,0,1,1,1,0,0,0.000046,0
1825,5B0938E8,2,0,2,0,0,0.000738,0,0.007271
1826,7ECBA3E0,2,2,4,0.625,10.333333,0.000003,0.000763,0.009195
1827,80EFBE52,1,0,1,0,0,0,0,0.003635
1828,5DB2DBB6,0,3,3,0.265537,0,0,0.008456,0
1829,5C919A18,1,0,1,0,0,0,0,0.003635
1830,816D69D6,0,8,8,0.52,0,0,0.024685,0
1831,5FDB4545,8,0,8,0,0,0.024838,0,0.078918
1832,78A84BBF,0,4,4,0.428571,0,0,0.006773,0
1833,7C19AEDE,5,5,10,0.555556,111,0.006287,0.010052,0.021195
1834,80D3AD00,7,0,7,0,0,0.020783,0,0.045189
1835,794226EB,1,0,1,0,0,0,0,0.003635
1836,7F20D84F,0,3,3,0.8,0,0,0.003128,0
1837,7E9C4C36,0,2,2,0.363636,0,0,0,0
1838,750DD764,6,0,6,0,0,0.009904,0,0.055646
1839,7FFEA557,1,0,1,0,0,0.000228,0,0.006566
1840,8127F33C,1,0,1,0,0,0.000085,0,0.003635
1841,7DA35DC7,0,1,1,1,0,0,0,0
1842,062051E1,3,0,3,0,0,0.021271,0,0.017772
1843,79A0E0F2,0,1,1,1,0,0,0.067616,0
1844,17942C0B,1,0,1,0,0,0.000767,0,0.003635
1845,7BBB3166,6,2,8,0.351852,381.959524,0.023863,0.001242,0.053096
1846,7DC534C5,0,2,2,0.555556,0,0,0.001058,0
1847,7F4FC409,1,2,3,0.666667,1,0.00024,0.068131,0.003635
1848,58E9C8C7,1,0,1,0,0,0.000011,0,0.003635
1849,0AABEB4B,1,0,1,0,0,0,0,0.007986
1850,8111DF5B,1,0,1,0,0,0.00048,0,0.005559
1851,7DCC667D,0,1,1,1,0,0,0,0
1852,7D0B66AB,3,1,4,1,6,0.000904,0.000159,0.016678
1853,7E2CCBA5,2,5,7,0.516129,38,0.003193,0.031674,0.009698
1854,77417F8E,5,0,5,0,0,0.000938,0,0.018177
1855,5ABD428D,1,0,1,0,0,0.001164,0,0.003635
1856,7E61E08C,4,1,5,1,12,0.004223,0.001299,0.032536
1857,8133B075,1,1,2,1,1,0,0.004493,0.003635
1858,7D32F652,3,6,9,0.5,69.833333,0.01171,0.017074,0.019105
1859,7CB1EED9,0,5,5,0.447368,0,0,0,0
1860,7BA83262,0,4,4,0.274194,0,0,0.001617,0
1861,7E80BCF8,0,1,1,1,0,0,0.000488,0
1862,805FBC44,0,2,2,0.75,0,0,0.005046,0
1863,7F297807,0,3,3,0.538462,0,0,0.001931,0
1864,78B1325A,3,0,3,0,0,0.00704,0,0.01283
1865,7D25812C,2,1,3,0.329897,32,0.000025,0.000293,0.007271
1866,80E68516,1,3,4,0.6,6,0.001782,0.00185,0.003635
1867,77F3F0A0,1,0,1,0,0,0,0,0.003635
1868,7CF6CF0A,27,6,33,0.8,276.366667,0.06421,0.010346,0.202979
1869,7F1C4A4C,1,0,1,0,0,0,0,0.003635
1870,7F17740A,3,0,3,0,0,0.000086,0,0.230452
1871,7B2A513F,0,1,1,0.666667,0,0,0.000201,0
1872,7D2C2E41,2,0,2,0,0,0.004484,0,0.01689
1873,7AE3E351,0,2,2,1,0,0,0.000168,0
1874,7E2FCE13,0,5,5,0.428571,0,0,0.00033,0
1875,7CF89A96,1,23,24,0.411638,187.5,0.001109,0.040997,0.003635
1876,7D3F6DC3,1,0,1,0,0,0.009002,0,0.046356
1877,5B0B1620,1,0,1,0,0,0,0,0.003635
1878,7D177A1E,1,1,2,0.391304,6,0.00121,0.001097,0.003635
1879,7DCBCB96,1,1,2,1,2,0,0,0.005559
1880,76A58A68,1,0,1,0,0,0,0,0.003635
1881,6CAE9F4C,1,0,1,0,0,0,0,0.009407
1882,813B0BD0,0,2,2,0.666667,0,0,0.005941,0
1883,7FC2A994,2,2,4,1,4,0,0.0016,0.007271
1884,7F5278B2,2,0,2,0,0,0.013142,0,0.007271
1885,010FB9FD,1,0,1,0,0,0.001102,0,0.003635
1886,76789C8B,2,0,2,0,0,0.022844,0,0.030356
1887,78C65F09,1,3,4,0.545455,43,0.008899,0.069996,0.007255
1888,7F42FFB5,6,0,6,0,0,0.001837,0,0.029508
1889,8115AD14,1,3,4,0.381818,21,0,0.068645,0.003635
1890,7FDB87C2,1,2,3,0.75,1.5,0.000016,0.005046,0.003635
1891,7AAB8D1A,1,1,2,1,0,0.005848,0.000502,0.003635
1892,79DCD2A2,4,0,4,0,0,0.006759,0,0.014542
1893,7805DB30,1,0,1,0,0,0.001344,0,0.003635
1894,7E009568,1,3,4,0.4,12,0,0.000056,0.003635
1895,7F6326B5,1,1,2,1,2,0.000124,0.067616,0.005559
1896,71652C5A,4,0,4,0,0,0.011939,0,0.024664
1897,7BE62AC2,4,0,4,0,0,0.000652,0,0.031116
1898,045F6D5C,0,1,1,0.666667,0,0,0.000523,0
1899,78B37016,1,4,5,0.37037,37.5,0.00466,0.00429,0.005559
1900,7E66F063,0,3,3,0.299065,0,0,0.004738,0
1901,5F38B07E,1,0,1,0,0,0,0,0.009258
1902,7DFBE238,2,2,4,0.363636,35,0.000664,0.00029,0.009195
1903,7ABA576E,11,0,11,0,0,0.000829,0,0.208214
1904,7E63C654,0,4,4,0.318182,0,0,0.00024,0
1905,7F7ACB1E,1,0,1,0,0,0.003747,0,0.016185
1906,7DF8BE1E,1,1,2,0.32,15,0.000288,0.00004,0.003635
1907,0924C847,0,12,12,0.772727,0,0,0.011627,0
1908,80EABDF6,6,4,10,0.615385,152.666667,0.003516,0.000718,0.044571
1909,7E63C899,0,1,1,1,0,0,0,0
1910,812E9AC3,0,3,3,1,0,0,0.009646,0
1911,76B306FF,1,0,1,0,0,0.000473,0,0.005559
1912,7ED52A44,1,1,2,0.666667,4,0.000433,0.000806,0.005559
1913,80D037B7,3,4,7,0.833333,91,0.000074,0.000585,0.02826
1914,5960A6CD,0,4,4,1,0,0,0.072048,0
1915,80116080,0,2,2,0.75,0,0,0,0
1916,6408F547,0,6,6,0.313131,0,0,0.004522,0
1917,7E3369D6,5,0,5,0,0,0.00407,0,0.036588
1918,805FB6DE,0,1,1,0.295455,0,0,0,0
1919,7F68072B,5,0,5,0,0,0.018735,0,0.094139
1920,80C93297,0,1,1,1,0,0,0,0
1921,7BDBFD8F,3,2,5,0.375,137.5,0.000882,0.000254,0.056149
1922,7EC4707A,1,0,1,0,0,0,0,0.003635
1923,7D41501B,0,2,2,1,0,0,0.001766,0
1924,75A835D1,2,0,2,0,0,0.00345,0,0.019821
1925,7FAE8AE4,0,3,3,1,0,0,0.000083,0
1926,813E640F,10,53,63,0.534314,1024.916667,0.013988,0.108882,0.038278
1927,7579C5F8,1,0,1,0,0,0.001782,0,0.003635
1928,7ACB88F4,1,8,9,0.331967,80,0.000248,0.002859,0.003635
1929,004ADD9E,1,4,5,0.352941,0,0.000334,0.003861,0.003635
1930,7D3D073A,0,1,1,0.321429,0,0,0.000296,0
1931,7F042DF2,0,3,3,1,0,0,0.003363,0
1932,806EE2C6,3,0,3,0,0,0.000833,0,0.01283
1933,7E3F03E9,0,1,1,0.281553,0,0,0.003989,0
1934,7FD71324,2,0,2,0,0,0.000046,0,0.007271
1935,7B1DD2CD,8,0,8,0,0,0.003976,0,0.092374
1936,812D810E,5,2,7,0.75,250.333333,0.012536,0.001068,0.099149
1937,7B7F970C,3,0,3,0,0,0.000004,0,0.019608
1938,804FF5BB,0,1,1,0.314286,0,0,0.000032,0
1939,80DCCD52,4,0,4,0,0,0.001775,0,0.038309
1940,06CF93BC,0,1,1,0.4375,0,0,0.001561,0
1941,81309448,0,1,1,1,0,0,0.000312,0
1942,7F9E1B64,3,0,3,0,0,0.000278,0,0.01283
1943,80C474D1,1,0,1,0,0,0.000571,0,0.003635
1944,7EA35993,3,11,14,0.46875,72.5,0.000016,0.003346,0.010906
1945,75A53766,0,1,1,1,0,0,0.001594,0
1946,80BBBEE8,1,2,3,0.252874,1,0.000632,0.000083,0.003635
1947,7EDE0A55,4,0,4,0,0,0.02202,0,0.020313
1948,7FCC4F81,2,0,2,0,0,0.012649,0,0.009698
1949,7EAADBBE,1,4,5,1,2.5,0.00251,0.037913,0.003635
1950,5CCC25C7,1,0,1,0,0,0,0,0.006063
1951,594DB6E1,1,6,7,0.535714,12.75,0.000167,0.00267,0.007483
1952,7E3D86D5,3,3,6,1,13.333333,0.014207,0.073275,0.015257
1953,62A4E0BC,0,6,6,0.53125,0,0,0.006323,0
1954,7B64D25B,4,0,4,0,0,0.01363,0,0.018389
1955,7DE4987E,0,2,2,1,0,0,0.000204,0
1956,7FA8C748,6,1,7,1,46.166667,0.00982,0.00729,0.057956
1957,7585EE08,1,1,2,0.345455,14,0.000522,0.00058,0.003635
1958,7DEB7CAE,0,2,2,0.6,0,0,0.000212,0
1959,800FA964,0,1,1,1,0,0,0,0
1960,75E63556,1,0,1,0,0,0.000378,0,0.003635
1961,588E5C50,2,0,2,0,0,0.003907,0,0.007271
1962,7DEE92C0,10,0,10,0,0,0.011579,0,0.047897
1963,76801F1E,2,0,2,0,0,0.001731,0,0.007271
1964,5C195EA6,1,1,2,0.448276,11,0.001102,0.013735,0.003635
1965,80C854BB,0,1,1,0.428571,0,0,0.00028,0
1966,76952449,1,2,3,1,2,0.00003,0,0.003635
1967,7ACE32A7,0,2,2,1,0,0,0.005681,0
1968,78315A76,0,2,2,1,0,0,0.068111,0
1969,7BBAB9CD,0,1,1,1,0,0,0.000323,0
1970,80CC247F,2,4,6,0.538462,27,0.007028,0.014313,0.014966
1971,7D82B3B9,1,3,4,0.481481,0,0.001655,0.018743,0.003635
1972,81148705,0,1,1,0.666667,0,0,0,0
1973,79419EFC,1,0,1,0,0,0.000611,0,0.005559
1974,7FC9EB57,0,1,1,0.6,0,0,0,0
1975,7B0E3750,0,52,52,0.455253,0,0,0.06671,0
1976,780C2A37,0,1,1,1,0,0,0,0
1977,805412F1,0,1,1,1,0,0,0,0
1978,7D2D1AB4,3,1,4,1,4,0.007037,0,0.01283
1979,5D049507,0,1,1,0.265306,0,0,0.000049,0
1980,75B7C9DC,11,1,12,1,48.5,0.036396,0.00342,0.110746
1981,722A3975,11,0,11,0,0,0.044958,0,0.107208
1982,7DF1EBF4,1,1,2,0.29,26,0.000522,0.002305,0.003635
1983,80E5DFE9,0,1,1,0.444444,0,0,0.000732,0
1984,798FCABA,0,4,4,0.4,0,0,0.00316,0
1985,7F3CC257,1,0,1,0,0,0,0,0.003635
1986,7FA0417F,1,2,3,1,2,0,0.000994,0.003635
1987,7DAB8431,1,0,1,0,0,0.00014,0,0.003635
1988,7B242EED,0,2,2,0.666667,0,0,0.000062,0
1989,801E6383,1,2,3,0.307692,0,0.000006,0.000072,0.003635
1990,5DB1B923,2,0,2,0,0,0.000482,0,0.007271
1991,80885F38,0,1,1,0.666667,0,0,0,0
1992,7A81A372,2,0,2,0,0,0.002505,0,0.019494
1993,80775CBB,0,5,5,0.692308,0,0,0.012967,0
1994,7F6E733B,1,0,1,0,0,0.009279,0,0.023377
1995,5D01CF63,2,1,3,1,2,0.000738,0,0.007271
1996,7F2DD7C6,2,0,2,0,0,0.000056,0,0.009698
1997,58A9C279,0,1,1,1,0,0,0,0
1998,786B9A88,1,0,1,0,0,0.000767,0,0.003635
1999,7F0EE353,2,0,2,0,0,0.001269,0,0.009195
2000,7E302936,1,1,2,1,1,0,0,0.003635
2001,7E86AB80,15,6,21,0.541667,145.211905,0.046144,0.022584,0.109176
2002,771FD4D6,0,1,1,1,0,0,0.00087,0
2003,814035D4,0,2,2,1,0,0,0.001077,0
2004,5BAE5F5F,0,16,16,0.518072,0,0,0.104273,0
2005,81126262,0,3,3,0.636364,0,0,0.00187,0
2006,7E5C9011,0,3,3,0.352941,0,0,0.000673,0
2007,7E190BE8,0,3,3,0.5,0,0,0.000387,0
2008,0212E7B5,2,1,3,0.411765,7,0.00014,0.000041,0.048667
2009,7BD455B4,1,0,1,0,0,0.00466,0,0.005559
2010,7F12DEA5,4,0,4,0,0,0.000288,0,0.025758
2011,80ADCF63,0,2,2,0.6,0,0,0.004801,0
2012,7ED6D688,3,1,4,1,4,0.000677,0,0.01283
2013,7B629EBF,0,1,1,1,0,0,0.00005,0
2014,7C61E792,1,0,1,0,0,0.000135,0,0.003635
2015,5A970B68,1,0,1,0,0,0.000055,0,0.006063
2016,7CD65F1C,0,10,10,0.433333,0,0,0.000214,0
2017,7EF193B3,0,5,5,0.777778,0,0,0.009404,0
2018,5ABF40BA,1,0,1,0,0,0.000176,0,0.003635
2019,76873E51,1,0,1,0,0,0.000611,0,0.005559
2020,7FF2CB89,0,3,3,0.714286,0,0,0.002186,0
2021,77517D51,5,5,10,0.45614,143.833333,0.003468,0.014305,0.028299
2022,6246C011,1,0,1,0,0,0.000021,0,0.00615
2023,7B3D9F12,1,0,1,0,0,0.000368,0,0.003635
2024,7F492829,1,0,1,0,0,0.005685,0,0.003635
2025,72242EC6,5,0,5,0,0,0.013125,0,0.084695
2026,59089F89,0,1,1,1,0,0,0,0
2027,6F0C4900,2,0,2,0,0,0.00003,0,0.007271
2028,8091DA86,1,0,1,0,0,0.000003,0,0.003635
2029,75EC525A,5,0,5,0,0,0.001181,0,0.018177
2030,7DDF15E2,1,1,2,0.428571,12,0.00007,0.006056,0.007483
2031,7EAE8091,0,3,3,0.375,0,0,0.001548,0
2032,7F6B1C15,0,2,2,0.375,0,0,0.000256,0
2033,7F93000C,0,1,1,0.666667,0,0,0.006242,0
2034,7874561A,0,3,3,0.571429,0,0,0.000271,0
2035,7F32F0C6,0,7,7,0.283951,0,0,0.077239,0
2036,80BDDDBC,0,4,4,0.433333,0,0,0.000179,0
2037,75096E68,1,6,7,0.875,7,0,0.00644,0.003635
2038,7F213D42,8,0,8,0,0,0.00175,0,0.223076
2039,8056840B,1,3,4,0.666667,0,0.000767,0.000707,0.003635
2040,7EC0D00E,0,2,2,0.351852,0,0,0.001242,0
2041,784B71BE,1,0,1,0,0,0.000511,0,0.005559
2042,78689B90,0,2,2,1,0,0,0.003213,0
2043,7F9B6B20,3,1,4,0.666667,12,0.021792,0.006242,0.020525
2044,7F496802,0,1,1,1,0,0,0,0
2045,7D57AC01,0,4,4,0.4,0,0,0.000817,0
2046,80AAB3EB,17,1,18,1,98,0.017987,0.000065,0.291187
2047,751A9EA8,10,0,10,0,0,0.002733,0,0.06012
2048,7E178D42,0,4,4,0.367925,0,0,0.002405,0
2049,801DA4EE,22,4,26,0.5,449.769048,0.002952,0.001378,0.1736
2050,80AE9AB3,1,0,1,0,0,0.003638,0,0.003635
2051,7DA9495F,0,1,1,1,0,0,0.000106,0
2052,7E8EC582,0,3,3,1,0,0,0.002112,0
2053,7F699CB4,0,5,5,0.355769,0,0,0.004667,0
2054,7EA0C1D3,0,4,4,0.387097,0,0,0.007489,0
2055,8095D642,1,4,5,0.75,43,0.000857,0.005522,0.013943
2056,724E5CD1,5,0,5,0,0,0.002449,0,0.030727
2057,7D93C4BB,0,1,1,1,0,0,0.002723,0
2058,768F331A,2,0,2,0,0,0.00102,0,0.010375
2059,761E946F,0,1,1,1,0,0,0,0
2060,76EC8314,3,0,3,0,0,0.002018,0,0.020525
2061,75C857B3,0,1,1,1,0,0,0,0
2062,7ADBAAFC,1,0,1,0,0,0.000196,0,0.003635
2063,7DE63201,1,0,1,0,0,0.000462,0,0.003635
2064,80DDC668,0,6,6,0.611111,0,0,0.000216,0
2065,80D4268E,3,0,3,0,0,0.002354,0,0.016678
2066,7833EF29,0,1,1,1,0,0,0.000441,0
2067,6B8CB820,4,0,4,0,0,0.002344,0,0.028008
2068,7DED5DC6,4,3,7,0.533333,47,0.000456,0.004155,0.018893
2069,816C8FEF,4,0,4,0,0,0.029814,0,0.076344
2070,7DF5A444,0,1,1,1,0,0,0,0
2071,77216EF2,1,0,1,0,0,0.000211,0,0.007986
2072,7F6E98BF,0,2,2,0.666667,0,0,0.000348,0
2073,7E395CCE,1,3,4,0.571429,7.5,0.001036,0.000044,0.003635
2074,7E0D1DAA,1,5,6,0.293651,34,0,0.000001,0.003635
2075,651E7275,8,0,8,0,0,0.000225,0,0.102263
2076,7D566F6F,1,3,4,0.666667,20.5,0.002464,0.075296,0.007921
2077,7D142359,0,6,6,0.371429,0,0,0.003918,0
2078,0BBB77BD,0,2,2,0.538462,0,0,0.000146,0
2079,7AAE3573,0,1,1,1,0,0,0,0
2080,777E973B,3,0,3,0,0,0.000773,0,0.016678
2081,796F05E4,0,1,1,0.666667,0,0,0.000046,0
2082,8065B0B0,0,2,2,0.555556,0,0,0.002851,0
2083,61962036,3,0,3,0,0,0.002197,0,0.020525
2084,76D27AF0,4,3,7,1,8.666667,0.000129,0.001293,0.026588
2085,7F3FE7BA,1,5,6,0.307692,38.666667,0,0.000044,0.005559
2086,7E15AB47,0,1,1,1,0,0,0.000149,0
2087,7D623CE3,0,1,1,0.428571,0,0,0.00028,0
2088,80FBDB08,0,1,1,1,0,0,0,0
2089,7F0DCEDB,0,3,3,1,0,0,0.001382,0
2090,7E6207F9,1,1,2,1,0,0,0.000001,0.003635
2091,7F42F93C,3,1,4,1,1,0.000242,0.001351,0.01283
2092,7F993176,0,5,5,0.306122,0,0,0.000001,0
2093,7D26C449,0,10,10,0.432836,0,0,0.083742,0
2094,7D496751,0,3,3,1,0,0,0.000288,0
2095,80211B51,1,0,1,0,0,0.000061,0,0.007483
2096,7C26CE3D,2,2,4,0.354545,78,0,0.000098,0.007271
2097,637FED49,1,1,2,1,0,0.000023,0.000002,0.003635
2098,02C0C59A,2,0,2,0,0,0.01622,0,0.022661
2099,7E4CB5FE,1,3,4,0.391304,2.5,0.000018,0.003577,0.003635
2100,7F97AC14,1,0,1,0,0,0.003231,0,0.005559
2101,810FC9A4,5,13,18,0.314815,247,0.00058,0.108249,0.020101
2102,80260C0F,1,0,1,0,0,0.000008,0,0.005559
2103,7C95D647,0,8,8,0.352273,0,0,0.003379,0
2104,80F58DF8,0,1,1,1,0,0,0,0
2105,7D957A2E,0,2,2,0.75,0,0,0.001142,0
2106,687CD3F9,0,1,1,1,0,0,0,0
2107,5BF5FA23,0,4,4,0.578947,0,0,0.014476,0
2108,801E82EE,0,1,1,1,0,0,0,0
2109,80F35A39,0,2,2,1,0,0,0.006493,0
2110,76648676,1,0,1,0,0,0.000767,0,0.003635
2111,5ADF7587,1,2,3,0.571429,0,0.004983,0.007806,0.009407
2112,787CFA31,1,0,1,0,0,0.000522,0,0.003635
2113,801B8182,1,4,5,0.5,16,0,0.000245,0.006063
2114,7F8F5DB9,0,1,1,1,0,0,0.000001,0
2115,7FC18AE6,0,1,1,1,0,0,0.001754,0
2116,7BD9ADC4,3,8,11,0.307692,159.166667,0.018035,0.01278,0.02822
2117,7D2AA97F,0,9,9,0.292683,0,0,0.006121,0
2118,7D60D169,1,2,3,1,4,0.003494,0.000262,0.005559
2119,815545A5,2,7,9,0.522727,46,0,0.118897,0.007271
2120,5EC8F1D1,3,0,3,0,0,0.000295,0,0.016678
2121,81061EC6,2,3,5,0.295455,41,0.001942,0.00752,0.009195
2122,7D860163,0,6,6,0.55,0,0,0.007747,0
2123,7D69EC6F,1,0,1,0,0,0.001632,0,0.009407
2124,7A02B2E3,2,0,2,0,0,0,0,0.011118
2125,6F6A2DFA,1,0,1,0,0,0.000028,0,0.003635
2126,7DAB5EA8,13,0,13,0,0,0.032117,0,0.185464
2127,7DFAFB09,0,1,1,0.254717,0,0,0.000299,0
2128,7D393E49,17,1,18,1,33.5,0.03759,0.001488,0.14252
2129,8064CB39,5,4,9,0.75,29.283333,0.013144,0.012105,0.033748
2130,0E276BAB,1,0,1,0,0,0.000757,0,0.003635
2131,7ABA5AE4,0,7,7,0.274566,0,0,0.002912,0
2132,7CFB6558,0,1,1,0.666667,0,0,0.000815,0
2133,7F979DDA,0,2,2,1,0,0,0,0
2134,7568E634,0,2,2,1,0,0,0.000012,0
2135,800AEB6B,1,2,3,1,2,0.005805,0.016516,0.003635
2136,7F65C192,0,4,4,0.5,0,0,0.031342,0
2137,58BC2EC9,2,3,5,0.6,4.5,0.001778,0.079696,0.007271
2138,806E49E7,0,1,1,1,0,0,0,0
2139,7E3C0BC0,0,3,3,0.535714,0,0,0.000722,0
2140,7E1768EF,2,2,4,0.444444,17,0.000951,0.003606,0.009195
2141,77F3DBB3,1,0,1,0,0,0.005847,0,0.003635
2142,7EA415AD,2,2,4,1,5.333333,0.000843,0.018214,0.009195
2143,5F434A35,12,0,12,0,0,0.029124,0,0.290112
2144,7D8E2F00,0,1,1,0.666667,0,0,0,0
2145,80344A5B,8,1,9,1,46,0.009559,0,0.079499
2146,80D25A19,1,0,1,0,0,0.000017,0,0.003635
2147,7DCBCB60,7,4,11,1,13.233333,0.002157,0.006343,0.065462
2148,7F1FAEAC,3,0,3,0,0,0.000429,0,0.020615
2149,7D7E8835,0,3,3,0.8,0,0,0.029846,0
2150,7F90E713,0,1,1,1,0,0,0,0
2151,7D2DECAC,0,3,3,0.483871,0,0,0.081946,0
2152,7FC8871C,2,4,6,0.5625,12.7,0.004929,0.073773,0.009195
2153,7F4E36CF,3,1,4,1,3,0.00266,0.00729,0.017181
2154,806EECE0,1,2,3,1,1.5,0,0.00001,0.003635
2155,7F86C8B0,2,0,2,0,0,0.001129,0,0.007271
2156,7784F371,5,0,5,0,0,0.008905,0,0.026376
2157,7D64900A,1,9,10,0.5,14.981746,0.00466,0.047335,0.005559
2158,7D68690D,0,2,2,1,0,0,0,0
2159,7D2C805B,0,2,2,1,0,0,0.001726,0
2160,7354AD96,1,0,1,0,0,0.000389,0,0.003635
2161,81018B28,1,1,2,1,10,0.000164,0.00008,0.013435
2162,641BEE0F,0,2,2,1,0,0,0.001756,0
2163,7AF428E9,0,2,2,1,0,0,0.000105,0
2164,7E613041,27,1,28,1,22.083333,0.039139,0.003126,0.146873
2165,7EC25CD7,16,3,19,1,120.5,0.038553,0.007515,0.122375
2166,7CD0181B,0,3,3,0.8,0,0,0.006434,0
2167,58EA4CE6,1,0,1,0,0,0,0,0.007483
2168,7F69A5BE,1,2,3,1,2,0.005685,0.000055,0.003635
2169,7FDC259F,1,2,3,1,1,0.000594,0.001726,0.003635
2170,753D3E9E,7,1,8,1,19,0.023804,0.001428,0.071747
2171,5F0F5F47,7,0,7,0,0,0.018138,0,0.037494
2172,7FC2A244,0,1,1,1,0,0,0.000023,0
2173,7EBFA915,1,0,1,0,0,0.000034,0,0.006827
2174,7B45F377,2,20,22,0.349091,121.916667,0.001202,0.056464,0.007271
2175,80BA5AC2,1,4,5,0.466667,24.5,0.000011,0.0002,0.003635
2176,790B82E9,1,0,1,0,0,0.009279,0,0.023377
2177,7F0EBFA7,0,1,1,1,0,0,0,0
2178,78BEF9E7,1,0,1,0,0,0,0,0.007342
2179,7F539EC9,1,0,1,0,0,0,0,0.003635
2180,811F8C14,0,3,3,1,0,0,0.00456,0
2181,5BDBE12A,3,0,3,0,0,0.000142,0,0.010906
2182,5D159E27,0,2,2,0.75,0,0,0.004862,0
2183,8152E7D8,3,3,6,0.666667,63.5,0.01233,0.004759,0.032571
2184,793207E2,0,3,3,0.337209,0,0,0.0004,0
2185,7D43A05B,1,3,4,1,3,0,0.000919,0.003635
2186,7562F9C5,1,1,2,0.666667,2,0.000546,0.004088,0.003635
2187,81227BAD,5,5,10,0.555556,33.5,0.002723,0.086872,0.018177
2188,71F397E8,3,0,3,0,0,0.000192,0,0.01342
2189,7B414499,0,2,2,0.357143,0,0,0.01402,0
2190,7C590678,6,0,6,0,0,0.024012,0,0.048926
2191,7E3BB467,5,10,15,0.6,92.5,0.000876,0.016717,0.022025
2192,7EFB9D0B,18,10,28,0.466667,421.916667,0.028763,0.120676,0.079911
2193,5AC1F87B,3,0,3,0,0,0,0,0.01283
2194,8054009E,0,31,31,0.391892,0,0,0.009002,0
2195,7F9FDA19,1,0,1,0,0,0,0,0.003635
2196,5A9A22D3,2,1,3,1,2.5,0.000189,0.003847,0.009195
2197,7F0582DB,2,0,2,0,0,0.001536,0,0.007271
2198,7DB9EC54,0,1,1,1,0,0,0.000381,0
2199,5D288C7B,0,1,1,1,0,0,0.001238,0
2200,59960D65,2,0,2,0,0,0.000023,0,0.011118
2201,76213A3C,1,0,1,0,0,0.000399,0,0.003635
2202,80EF2F28,0,5,5,0.516129,0,0,0.018762,0
2203,78FFD5E5,0,1,1,1,0,0,0,0
2204,7710F7D8,1,0,1,0,0,0.000006,0,0.005559
2205,80093347,1,0,1,0,0,0.001807,0,0.003635
2206,7ECB1920,2,1,3,0.454545,10,0,0,0.007271
2207,790931F4,1,0,1,0,0,0.007459,0,0.003635
2208,8160B0CE,1,0,1,0,0,0,0,0.003635
2209,7CD7F8A7,1,0,1,0,0,0.000002,0,0.005559
2210,7AE375F9,4,0,4,0,0,0.001222,0,0.025166
2211,79282E30,0,1,1,1,0,0,0,0
2212,7EB9894C,0,5,5,0.666667,0,0,0.00624,0
2213,5D5BA24E,0,2,2,0.351852,0,0,0.001242,0
2214,7B104781,1,0,1,0,0,0,0,0.005559
2215,77E5DF0A,1,0,1,0,0,0,0,0.003635
2216,7ECD3E51,0,2,2,1,0,0,0,0
2217,7FB89A0D,3,0,3,0,0,0.016725,0,0.030647
2218,58377350,0,2,2,0.571429,0,0,0.000001,0
2219,77252DC4,0,3,3,0.583333,0,0,0.004812,0
2220,7D78C12A,1,0,1,0,0,0,0,0.003635
2221,7F6CDAAD,0,3,3,0.8,0,0,0.005346,0
2222,796FC914,0,4,4,0.279412,0,0,0.000625,0
2223,5D732B7E,3,0,3,0,0,0.020608,0,0.017304
2224,5E42676D,1,0,1,0,0,0.000033,0,0.003635
2225,61DFB193,2,0,2,0,0,0.001771,0,0.019821
2226,7F0C468E,9,0,9,0,0,0.000937,0,0.087243
2227,7DFCF018,1,0,1,0,0,0,0,0.005559
2228,00EFF9AD,2,0,2,0,0,0.016502,0,0.028613
2229,5BE387EC,0,1,1,1,0,0,0.000181,0
2230,7D2C0535,3,0,3,0,0,0.020914,0,0.016449
2231,80508BA5,0,1,1,0.666667,0,0,0.000016,0
2232,797DDD82,1,0,1,0,0,0.016102,0,0.019026
2233,7C80A9DD,0,4,4,0.287037,0,0,0.001886,0
2234,7F2310A9,0,3,3,0.454545,0,0,0.012439,0
2235,7D9CCA67,6,5,11,0.5,107.166667,0.012662,0.022247,0.028087
2236,817A4472,4,0,4,0,0,0.009073,0,0.067489
2237,7C434A14,0,3,3,0.486486,0,0,0.014534,0
2238,7E22C479,0,2,2,0.336735,0,0,0.000295,0
2239,6D5DABC2,0,9,9,0.612903,0,0,0.000296,0
2240,7E073AC1,0,1,1,1,0,0,0.000004,0
2241,80C988C4,0,3,3,0.253012,0,0,0.00069,0
2242,5D602E13,1,0,1,0,0,0.000023,0,0.003635
2243,07952ADC,0,4,4,0.269006,0,0,0.072964,0
2244,04E189D7,1,0,1,0,0,0.010891,0,0.005559
2245,7A8A9CA4,2,0,2,0,0,0.005873,0,0.009195
2246,7EF737F6,4,1,5,1,2,0.000398,0.001594,0.016465
2247,802FB277,7,0,7,0,0,0.020455,0,0.071469
2248,7C4374EF,1,0,1,0,0,0.000018,0,0.003635
2249,76604564,1,0,1,0,0,0.006424,0,0.003635
2250,7F24F3CE,2,0,2,0,0,0.004241,0,0.017897
2251,7D6F6428,6,5,11,1,4.566667,0.00288,0.006527,0.040637
2252,7EFA779F,0,1,1,1,0,0,0.000001,0
2253,7F21CB24,0,1,1,0.666667,0,0,0,0
2254,7DEC0AAE,1,0,1,0,0,0,0,0.003635
2255,7B74A3CC,1,0,1,0,0,0.000767,0,0.003635
2256,7E54174B,0,1,1,0.666667,0,0,0.000841,0
2257,81421F10,1,9,10,0.372449,46.5,0.00466,0.011902,0.005559
2258,7AE915E8,2,0,2,0,0,0.005954,0,0.009698
2259,78D2CEB9,2,0,2,0,0,0.000043,0,0.007271
2260,78C3C8EB,0,1,1,1,0,0,0.000156,0
2261,80C542AA,0,2,2,1,0,0,0.000589,0
2262,78ADD56D,8,1,9,1,17.5,0.004307,0.000323,0.056874
2263,7B72F359,0,5,5,0.484848,0,0,0.008863,0
2264,7C348284,0,3,3,0.615385,0,0,0.000574,0
2265,7AD484D1,0,1,1,1,0,0,0.000177,0
2266,75B91A56,2,0,2,0,0,0.007726,0,0.007271
2267,7692CFEF,3,0,3,0,0,0.005067,0,0.01283
2268,6048FE90,6,1,7,1,14,0.01807,0.00001,0.049249
2269,80096B49,0,7,7,0.320611,0,0,0.010246,0
2270,8005A72B,0,1,1,0.666667,0,0,0.000296,0
2271,7E8C8936,7,1,8,1,9.5,0.00603,0.000105,0.052145
2272,79BEBAFD,2,0,2,0,0,0.000764,0,0.009195
2273,7CB36F52,1,0,1,0,0,0.000003,0,0.003635
2274,809959D7,0,1,1,0.666667,0,0,0.005135,0
2275,8106AE52,1,0,1,0,0,0.000151,0,0.003635
2276,7E195EBD,0,2,2,1,0,0,0.000493,0
2277,7DEC4BDB,1,0,1,0,0,0.000058,0,0.003635
2278,5C085DA6,4,3,7,0.666667,61.083333,0.000075,0.000928,0.050252
2279,813D7565,4,4,8,0.833333,18,0.000104,0.001305,0.014542
2280,7E2DEDF7,0,2,2,1,0,0,0.00001,0
2281,7F994E74,0,1,1,1,0,0,0.000312,0
2282,7898B3ED,2,1,3,0.265306,1,0.000956,0.002034,0.009195
2283,79695204,2,0,2,0,0,0.014572,0,0.007271
2284,8104EA3C,0,6,6,0.875,0,0,0.001565,0
2285,7F4F459A,3,0,3,0,0,0.001582,0,0.010906
2286,7F52BED0,0,5,5,0.4,0,0,0.033175,0
2287,7FDDA648,0,3,3,1,0,0,0.019964,0
2288,7C895672,2,0,2,0,0,0.000581,0,0.007271
2289,811B8788,0,5,5,0.314394,0,0,0.021512,0
2290,7F2662BE,1,3,4,0.408163,6,0.001256,0.004623,0.003635
2291,79002788,1,0,1,0,0,0.000003,0,0.003635
2292,5A09ECA9,1,0,1,0,0,0.009279,0,0.023377
2293,7E3CDD5A,0,2,2,1,0,0,0.001153,0
2294,79B8D01C,1,0,1,0,0,0,0,0.003635
2295,7D3C5F65,0,1,1,1,0,0,0.000942,0
2296,809C7796,0,3,3,0.485714,0,0,0.02023,0
2297,686100D9,0,1,1,0.666667,0,0,0.000874,0
2298,8161D24C,1,0,1,0,0,0.00002,0,0.003635
2299,7FE3D684,2,0,2,0,0,0.001237,0,0.014049
2300,809B1EDE,0,1,1,1,0,0,0,0
2301,7F93C921,0,5,5,0.477273,0,0,0.014287,0
2302,80A00701,1,0,1,0,0,0.000081,0,0.003635
2303,7EDAC4F1,0,7,7,0.714286,0,0,0.024664,0
2304,7D4A4E8A,0,8,8,0.410256,0,0,0.006703,0
2305,81ECBBED,1,0,1,0,0,0,0,0.003635
2306,76058687,0,2,2,0.298851,0,0,0.000005,0
2307,7F5BBAA5,0,1,1,1,0,0,0,0
2308,78D9DF8F,0,1,1,0.37037,0,0,0.000002,0
2309,7D4F5729,26,2,28,1,68.5,0.022533,0.003275,0.179049
2310,7721530E,1,3,4,0.4,54.5,0.016102,0.006936,0.019026
2311,7E182033,2,1,3,1,18,0.000808,0,0.018829
2312,80ABD99B,1,2,3,0.307692,4,0.000325,0,0.003635
2313,5F8051C3,9,0,9,0,0,0.004044,0,0.103291
2314,7B913E36,4,0,4,0,0,0.001375,0,0.016465
2315,79931DF5,8,0,8,0,0,0.008903,0,0.045158
2316,7A966112,1,0,1,0,0,0,0,0.003635
2317,7D717DCA,0,1,1,0.473684,0,0,0.005472,0
2318,804DB006,0,1,1,0.666667,0,0,0.000052,0
2319,762CA6E5,1,0,1,0,0,0.000002,0,0.003635
2320,7F021F82,13,9,22,0.580645,790.131746,0.045623,0.1118,0.132296
2321,5F1BC5B2,2,0,2,0,0,0.000284,0,0.01464
2322,8020FCBC,3,0,3,0,0,0.002336,0,0.016678
2323,7DB8C3E2,1,1,2,0.32,3.333333,0,0.000236,0.005559
2324,7F780B9F,4,2,6,0.351852,57,0.000575,0.001242,0.016465
2325,7C208679,2,0,2,0,0,0.000023,0,0.009195
2326,01014831,15,0,15,0,0,0.045135,0,0.257197
2327,79D8D2E0,1,0,1,0,0,0,0,0.003635
2328,7E45F690,0,1,1,1,0,0,0.000441,0
2329,7CFEE30D,3,8,11,0.545455,45.166667,0.00979,0.045409,0.010906
2330,7DEC0590,0,2,2,1,0,0,0.000371,0
2331,784FA7B9,0,3,3,0.583333,0,0,0.000166,0
2332,815BAE4B,0,1,1,1,0,0,0.000824,0
2333,7956BD07,2,1,3,0.5,5,0.001384,0.002735,0.007271
2334,7E8CEA80,4,1,5,1,2,0.000014,0.000046,0.014542
2335,39F73722,0,3,3,0.27907,0,0,0.000019,0
2336,59CBF85E,3,0,3,0,0,0.009747,0,0.030647
2337,7CF90333,0,1,1,1,0,0,0,0
2338,80343E03,0,14,14,0.888889,0,0,0.007579,0
2339,79FC6A3F,3,0,3,0,0,0.001055,0,0.01283
2340,7D5A8922,0,1,1,1,0,0,0,0
2341,5BE013D7,1,0,1,0,0,0,0,0.003635
2342,592516BA,1,0,1,0,0,0,0,0.005559
2343,7C94C794,2,1,3,1,1.5,0.001005,0.013918,0.009195
2344,7EB6906C,1,0,1,0,0,0.000767,0,0.003635
2345,78FBC91E,1,1,2,1,1,0,0,0.003635
2346,7E402528,1,2,3,1,1,0.001213,0.028975,0.003635
2347,814CAE24,0,2,2,0.322581,0,0,0.000109,0
2348,7FB50A1E,0,3,3,0.355556,0,0,0.001219,0
2349,7785A4FA,4,1,5,0.6,20.033333,0.000501,0.000014,0.021186
2350,019CC03B,1,0,1,0,0,0.000003,0,0.003635
2351,806CA8B8,3,3,6,0.571429,27,0.015986,0.007819,0.016678
2352,7E615E88,1,0,1,0,0,0.000173,0,0.00615
2353,809DC253,1,0,1,0,0,0,0,0.005559
2354,7EB3E11F,0,14,14,0.545455,0,0,0.038738,0
2355,809D2806,0,1,1,0.424242,0,0,0.005047,0
2356,80D0453F,0,1,1,1,0,0,0.000253,0
2357,77112C25,1,0,1,0,0,0.000672,0,0.013254
2358,8098E46E,1,5,6,0.423077,90.333333,0,0.027382,0.013254
2359,7D4DA0C6,0,1,1,0.281553,0,0,0.003989,0
2360,7F7BBFC6,1,0,1,0,0,0.000129,0,0.003635
2361,7F75BCB0,2,0,2,0,0,0,0,0.007271
2362,7FE58786,1,0,1,0,0,0,0,0.005559
2363,78989576,4,0,4,0,0,0.008046,0,0.085144
2364,7CF3A3B8,3,9,12,0.5,73.166667,0.003235,0.041421,0.010906
2365,7DC241AC,0,1,1,0.666667,0,0,0.000613,0
2366,7E942BE8,0,1,1,1,0,0,0.067616,0
2367,788D8698,0,4,4,0.357724,0,0,0.011218,0
2368,76ABA5C3,0,6,6,0.315508,0,0,0.013553,0
2369,756BD45D,2,0,2,0,0,0.000294,0,0.009195
2370,7DCF4125,10,6,16,0.394366,594.166667,0.027052,0.013276,0.067496
2371,8155B1D5,1,0,1,0,0,0,0,0.003635
2372,7EBEF8F7,1,1,2,0.666667,5.666667,0.016102,0.001533,0.019026
2373,778582BB,4,0,4,0,0,0.00515,0,0.014542
2374,77D645C6,1,0,1,0,0,0.000135,0,0.003635
2375,7D65E5B8,15,0,15,0,0,0.022364,0,0.085992
2376,792F7511,1,0,1,0,0,0.001131,0,0.030306
2377,78CA0D0A,2,3,5,0.326087,50,0.010444,0.000335,0.027012
2378,79CDA013,0,5,5,0.357895,0,0,0.001927,0
2379,7E21109D,6,0,6,0,0,0.001217,0,0.02566
2380,7DF06F0F,2,1,3,0.666667,1.833333,0.000401,0.000534,0.007271
2381,8090B731,2,0,2,0,0,0.000332,0,0.007271
2382,80065A19,0,1,1,0.666667,0,0,0.000052,0
2383,6307B91A,1,2,3,0.625,0,0.000139,0.001604,0.003635
2384,8148B894,1,7,8,0.327684,20.47619,0.000699,0.018687,0.003635
2385,7D857492,0,2,2,0.29386,0,0,0.000573,0
2386,05176A8A,1,0,1,0,0,0,0,0.003635
2387,7D119B05,1,6,7,0.434211,33,0,0.020957,0.003635
2388,80793597,0,1,1,1,0,0,0.002723,0
2389,7594BF74,1,4,5,0.526316,2.5,0.000065,0.000799,0.003635
2390,7E950AAC,0,2,2,1,0,0,0.006423,0
2391,762FC3DF,0,5,5,0.346154,0,0,0.015578,0
2392,5FC68A3F,1,0,1,0,0,0,0,0.003635
2393,8068B3CF,0,1,1,0.30303,0,0,0.000636,0
2394,80513F65,0,3,3,0.345455,0,0,0.00574,0
2395,5AF9028F,6,1,7,1,207.5,0.008734,0.00342,0.105718
2396,7A70BC2D,2,0,2,0,0,0.000411,0,0.014049
2397,7BA4228C,1,0,1,0,0,0.00121,0,0.003635
2398,79696B59,1,4,5,0.392523,20.333333,0.005685,0.008735,0.003635
2399,80EC71F2,3,0,3,0,0,0.017887,0,0.032437
2400,7D76AD59,0,1,1,1,0,0,0,0
2401,7E5FC307,0,3,3,0.45,0,0,0.070189,0
2402,7E634E70,0,5,5,0.321429,0,0,0.000539,0
2403,7EB6AB88,1,1,2,1,1,0.000038,0.000104,0.003635
2404,815BDD95,0,3,3,0.344828,0,0,0.000123,0
2405,8092E289,1,0,1,0,0,0,0,0.003635
2406,7DA0ADAB,0,1,1,0.666667,0,0,0,0
2407,767AC815,2,0,2,0,0,0.00034,0,0.009195
2408,809E2834,0,2,2,0.75,0,0,0.000001,0
2409,5D257082,3,0,3,0,0,0.01548,0,0.010906
2410,80270349,0,1,1,1,0,0,0,0
2411,816192B3,35,8,43,0.514286,1619.37619,0.011126,0.004744,0.168178
2412,7FA04848,32,8,40,0.684211,1263,0.059223,0.105758,0.225999
2413,8153A092,0,7,7,0.384848,0,0,0.005652,0
2414,7A9F5CCC,0,2,2,0.75,0,0,0,0
2415,7FBDBB75,3,1,4,1,3,0.000209,0.000177,0.01283
2416,7D8654D7,3,3,6,0.481481,31,0.016086,0.007604,0.013334
2417,7196988F,1,0,1,0,0,0.005685,0,0.003635
2418,805322BB,5,0,5,0,0,0.000039,0,0.237813
2419,7BB9BB45,0,1,1,1,0,0,0.000068,0
2420,78184496,2,1,3,0.571429,4,0.016641,0.002655,0.022661
2421,5FB2BA17,2,0,2,0,0,0.000139,0,0.012125
2422,806DCE05,0,1,1,0.365854,0,0,0.00163,0
2423,7DCAFAE3,4,0,4,0,0,0.008278,0,0.041329
2424,029C9CBE,0,1,1,1,0,0,0,0
2425,7E5D5C0B,0,5,5,0.52,0,0,0.008059,0
2426,7D538A57,1,2,3,1,2,0.000729,0.000236,0.003635
2427,6E94BEDD,3,0,3,0,0,0.001229,0,0.010906
2428,81457564,1,0,1,0,0,0.000133,0,0.003635
2429,5E3D69B5,2,0,2,0,0,0.000051,0,0.009195
2430,7A842D34,1,0,1,0,0,0.000285,0,0.009407
2431,79292948,0,3,3,1,0,0,0.00158,0
2432,79D506AF,2,4,6,0.321739,74,0,0.001397,0.007271
2433,5A423C20,0,5,5,0.361111,0,0,0.021294,0
2434,5E8B0F6D,0,2,2,1,0,0,0.00002,0
2435,7E11B96B,5,19,24,0.764706,1456.478571,0.00066,0.001636,0.153874
2436,779E5B72,1,1,2,1,1,0.005847,0,0.003635
2437,7CF17B34,7,1,8,1,11,0.017012,0.00531,0.056732
2438,7D160B60,9,1,10,0.5,71.5,0.011872,0.01097,0.050714
2439,7F38BF22,0,3,3,0.583333,0,0,0.012403,0
2440,8113377A,0,3,3,0.8,0,0,0.001579,0
2441,7E51DE4C,0,1,1,1,0,0,0,0
2442,8136A9F3,1,0,1,0,0,0.000447,0,0.003635
2443,7EB9A4F8,0,5,5,0.625,0,0,0.00524,0
2444,7E286FD5,0,2,2,0.555556,0,0,0.000813,0
2445,81771CDC,7,2,9,1,6.083333,0.021025,0.006825,0.065771
2446,7D989323,2,2,4,0.666667,2,0.016512,0.007291,0.022661
2447,7D8777DD,1,1,2,1,1,0.00007,0,0.003635
2448,7E52F864,1,8,9,0.406504,95.666667,0.000244,0.086081,0.005559
2449,5CC9FFCF,0,5,5,0.308511,0,0,0.004406,0
2450,76AF36E2,1,7,8,0.818182,1.5,0.000025,0.000144,0.003635
2451,7F39AB72,0,2,2,0.666667,0,0,0.005227,0
2452,74308C3A,2,0,2,0,0,0.00979,0,0.03086
2453,75E37643,1,4,5,0.529412,14.25,0.000167,0.000916,0.007483
2454,0BBBF03D,1,0,1,0,0,0,0,0.003635
2455,8007D4E2,0,2,2,1,0,0,0.001393,0
2456,7D03F9B8,3,4,7,0.5,23,0.015003,0.002341,0.010906
2457,58EF6200,2,0,2,0,0,0.016221,0,0.031627
2458,7676DFE9,0,1,1,1,0,0,0.000506,0
2459,7DFC005A,0,1,1,0.666667,0,0,0.003336,0
2460,7E0EDCB7,3,4,7,0.833333,16.5,0.002791,0.008682,0.021029
2461,5D59274B,1,0,1,0,0,0.000039,0,0.003635
2462,7AEBFF19,0,1,1,1,0,0,0.067616,0
2463,7EBE5136,0,4,4,0.390805,0,0,0.003573,0
2464,7F767396,1,2,3,0.413793,87,0.000007,0.000105,0.007357
2465,5FB75050,0,2,2,0.307692,0,0,0.005407,0
2466,7DC52603,1,0,1,0,0,0.000028,0,0.003635
2467,7EAEB7BC,3,0,3,0,0,0.000132,0,0.01283
2468,7C1424C1,0,4,4,0.363636,0,0,0.008019,0
2469,7C23A134,2,0,2,0,0,0.005727,0,0.009195
2470,7FD7D108,0,1,1,1,0,0,0.001017,0
2471,807A36F3,1,0,1,0,0,0.001494,0,0.003635
2472,5B221F06,1,0,1,0,0,0,0,0.003635
2473,7F81BCF7,58,0,58,0,0,0.062306,0,0.437685
2474,7E9A4F83,4,4,8,0.75,8.366667,0.001098,0.00104,0.018389
2475,7D9921DD,2,2,4,0.5,21,0.000378,0.002598,0.007271
2476,75613E24,0,6,6,0.433962,0,0,0.01437,0
2477,7F52DB6B,0,3,3,0.457143,0,0,0.019262,0
2478,809737E5,2,0,2,0,0,0.000299,0,0.007271
2479,80844E87,0,1,1,1,0,0,0.000005,0
2480,80E021C8,0,2,2,0.283951,0,0,0,0
2481,7BA92A1B,3,0,3,0,0,0.001499,0,0.017331
2482,7D98CB6C,0,1,1,1,0,0,0,0
2483,7E534B73,0,1,1,0.5,0,0,0.000063,0
2484,7DEB5C6C,1,3,4,0.37037,0,0.000038,0.000433,0.003635
2485,06A17D27,1,0,1,0,0,0,0,0.003635
2486,5EFE8463,0,1,1,1,0,0,0.000071,0
2487,801ED810,0,2,2,0.75,0,0,0.000677,0
2488,7CFE16B8,1,0,1,0,0,0,0,0.008577
2489,5D1DCDC1,1,0,1,0,0,0,0,0.003635
2490,7E29C071,1,1,2,1,2,0.00466,0,0.005559
2491,7B79E38E,0,2,2,0.625,0,0,0.00092,0
2492,776FAE66,4,2,6,0.425532,586.833333,0.014345,0.011103,0.063538
2493,7F503F50,0,1,1,0.666667,0,0,0.000841,0
2494,7FBF9CDA,3,0,3,0,0,0.000639,0,0.01283
2495,7CFB4773,0,8,8,0.535714,0,0,0.016154,0
2496,7E170A22,2,0,2,0,0,0.001146,0,0.017393
2497,7E9C1EFC,0,2,2,0.666667,0,0,0.069159,0
2498,7CF10F89,0,2,2,0.434783,0,0,0,0
2499,7AEAE464,1,0,1,0,0,0,0,0.003635
2500,00E48D9B,2,0,2,0,0,0.006356,0,0.007271
2501,800AC511,2,0,2,0,0,0.013556,0,0.013668
2502,8139B18D,0,2,2,0.466667,0,0,0.006104,0
2503,7637F079,5,11,16,0.537313,238.666667,0.01585,0.063936,0.024955
2504,06152965,1,0,1,0,0,0,0,0.003635
2505,81607AEA,12,0,12,0,0,0.019067,0,0.124872
2506,7C6A08EE,1,2,3,0.75,3,0.000002,0.003567,0.003635
2507,7CE8CC6A,0,1,1,1,0,0,0.001549,0
2508,813ECC38,3,0,3,0,0,0.002665,0,0.013334
2509,786C8052,0,2,2,1,0,0,0.002885,0
2510,7D05406E,2,1,3,1,1,0.000134,0.000906,0.009195
2511,8110F8D8,0,5,5,0.391667,0,0,0.006956,0
2512,7E74F760,1,1,2,0.6,2,0.006449,0.006936,0.003635
2513,769557B5,4,6,10,0.521127,198.833333,0.001143,0.002198,0.020313
2514,5AFD7538,1,0,1,0,0,0.000536,0,0.003635
2515,7E9D2AC6,4,0,4,0,0,0.002665,0,0.020313
2516,79A822ED,12,4,16,0.833333,618.5,0.036292,0.006459,0.220567
2517,6F288B4A,4,10,14,0.560976,67.195238,0.028213,0.037624,0.045322
2518,760086FE,1,0,1,0,0,0,0,0.003635
2519,7EC64991,0,3,3,0.357798,0,0,0.001333,0
2520,7E6C03B9,3,1,4,1,1.333333,0.000923,0.000906,0.01283
2521,78E5DC23,3,0,3,0,0,0.014682,0,0.021709
2522,76DA4DEA,0,1,1,0.6,0,0,0,0
2523,7D57C644,0,2,2,1,0,0,0.000006,0
2524,7806AEE5,33,2,35,0.625,1185.966667,0.071061,0.000778,0.469458
2525,7D3B4D39,1,0,1,0,0,0.000462,0,0.003635
2526,7A9D0BCE,0,6,6,0.415385,0,0,0.004001,0
2527,729F1054,6,0,6,0,0,0.020366,0,0.042144
2528,72FF360A,0,1,1,1,0,0,0.013918,0
2529,08120223,5,3,8,1,3.166667,0.000154,0.000047,0.030223
2530,813F3EE9,3,0,3,0,0,0.000008,0,0.014754
2531,7A9918CE,4,0,4,0,0,0.017119,0,0.067385
2532,010D944E,1,0,1,0,0,0.000767,0,0.003635
2533,80D8264C,0,1,1,0.6,0,0,0,0
2534,7D05D92D,1,6,7,0.466667,7,0.000927,0.01088,0.003635
2535,58FF219F,0,4,4,0.340426,0,0,0.001513,0
2536,7F1C0A6C,3,3,6,0.666667,50,0.018315,0.001923,0.026296
2537,7F293F36,0,1,1,1,0,0,0.067616,0
2538,78F2B058,1,0,1,0,0,0.00466,0,0.005559
2539,6AFBE169,0,2,2,1,0,0,0.000281,0
2540,786F5F31,0,1,1,1,0,0,0,0
2541,814EFF23,0,1,1,1,0,0,0.000015,0
2542,7E04E291,0,5,5,0.4375,0,0,0.000411,0
2543,80C7DB3C,0,1,1,1,0,0,0,0
2544,058D88AF,1,7,8,0.37931,44,0,0.017345,0.003635
2545,5FDDE27B,4,0,4,0,0,0.007548,0,0.095107
2546,80C531D1,1,1,2,1,1,0.00002,0.001585,0.003635
2547,5F331A14,3,0,3,0,0,0.003038,0,0.051451
2548,8090A444,2,1,3,1,19,0.00375,0,0.026558
2549,0DFD6DCC,1,0,1,0,0,0.00006,0,0.013758
2550,5C50346A,0,3,3,0.6,0,0,0.029351,0
2551,80A78A1A,24,0,24,0,0,0.059502,0,0.481793
2552,7E41F638,0,1,1,1,0,0,0.00342,0
2553,5F344285,5,0,5,0,0,0.009887,0,0.046334
2554,7DE49A66,3,1,4,1,4.5,0.000544,0.000177,0.013432
2555,76612B14,0,7,7,0.397727,0,0,0.082757,0
2556,7FF2E41E,1,0,1,0,0,0.000135,0,0.003635
2557,798DF163,0,5,5,0.366197,0,0,0.075374,0
2558,7DBE7C85,0,1,1,0.666667,0,0,0,0
2559,7F2F600C,1,1,2,1,0,0,0,0.003635
2560,7DC13B42,1,1,2,1,1,0.000025,0,0.003635
2561,80D73FEB,0,6,6,0.436364,0,0,0.007859,0
2562,78B86909,0,1,1,0.281553,0,0,0.003989,0
2563,80E56436,0,1,1,0.6,0,0,0,0
2564,80AA5E5F,10,0,10,0,0,0.012331,0,0.122129
2565,816FD5F3,1,3,4,1,4,0.00751,0.002769,0.005559
2566,80F90EBB,0,1,1,0.424242,0,0,0.005047,0
2567,5B86B635,2,0,2,0,0,0.003549,0,0.009195
2568,7F299E55,7,0,7,0,0,0.028817,0,0.10497
2569,7FE6DAB1,0,2,2,0.625,0,0,0.002384,0
2570,7E762A75,1,1,2,1,1,0.000003,0,0.003635
2571,7DC2CE79,0,2,2,1,0,0,0.000949,0
2572,7D4D0154,2,0,2,0,0,0.000785,0,0.007271
2573,80DF9BC0,0,1,1,1,0,0,0.000065,0
2574,7F2AD47F,1,0,1,0,0,0,0,0.003635
2575,80CDF943,0,1,1,1,0,0,0.000024,0
2576,8067C959,0,2,2,0.309524,0,0,0.001361,0
2577,7D75E82F,0,2,2,0.4375,0,0,0.005194,0
2578,8025F958,4,3,7,0.44186,79.305556,0.006511,0.013087,0.022237
2579,7E0D4BC1,4,7,11,0.733333,127.022222,0.008094,0.019928,0.04902
2580,7EE28840,2,6,8,0.466667,42,0,0.001958,0.007271
2581,7FEB500B,1,0,1,0,0,0.000079,0,0.00615
2582,7FC31DD3,0,1,1,1,0,0,0,0
2583,7DE7475F,2,3,5,0.714286,6.666667,0.000048,0.000064,0.013042
2584,73A11F5C,5,0,5,0,0,0.025622,0,0.125602
2585,7F1BFB45,3,0,3,0,0,0.000042,0,0.020525
2586,7F953972,1,0,1,0,0,0.00208,0,0.003635
2587,767906BB,4,1,5,1,10,0.019574,0.001507,0.044676
2588,80397127,0,1,1,1,0,0,0,0
2589,7034B4F5,4,0,4,0,0,0.000562,0,0.014542
2590,77A49A8E,1,0,1,0,0,0.000023,0,0.003635
2591,79E58068,3,0,3,0,0,0.006441,0,0.015257
2592,742ED5EB,1,0,1,0,0,0,0,0.003635
2593,7AF4510E,1,0,1,0,0,0,0,0.003635
2594,7E1E9CC9,4,14,18,0.412698,142.152381,0.018845,0.052228,0.014542
2595,776EFE53,2,0,2,0,0,0.00012,0,0.034916
2596,5C38218B,1,0,1,0,0,0.000058,0,0.003635
2597,76485374,0,11,11,0.366667,0,0,0.005424,0
2598,7E8A31CA,0,3,3,0.268519,0,0,0.001128,0
2599,7C452421,0,2,2,1,0,0,0,0
2600,773F47BB,1,0,1,0,0,0.000114,0,0.007483
2601,80AFDD85,0,3,3,0.318182,0,0,0.005619,0
2602,813602A4,0,4,4,0.372881,0,0,0.005764,0
2603,7DD20706,1,2,3,0.4375,6,0.000075,0.000883,0.003635
2604,7E00D2B7,0,2,2,1,0,0,0.014624,0
2605,7DE9759E,1,0,1,0,0,0.000078,0,0.005559
2606,7FDB3074,4,2,6,0.44186,50,0.022343,0.017304,0.018389
2607,5F5F4DD3,2,0,2,0,0,0,0,0.009195
2608,76EA9212,1,0,1,0,0,0.001456,0,0.003635
2609,7FFC0A16,1,1,2,1,1,0,0.000016,0.007717
2610,811E1299,2,0,2,0,0,0,0,0.009195
2611,78BA213B,0,8,8,0.414966,0,0,0.004783,0
2612,7C270F07,0,2,2,0.38,0,0,0.001243,0
2613,7D0ECD0F,3,0,3,0,0,0.003055,0,0.016536
2614,80A2095F,1,3,4,0.666667,5.5,0.000522,0.010403,0.003635
2615,7D80E72E,0,1,1,1,0,0,0,0
2616,7F9BFA86,0,2,2,1,0,0,0.004806,0
2617,7E36188A,0,1,1,1,0,0,0,0
2618,78DB47B5,3,0,3,0,0,0,0,0.015257
2619,7FFC0C30,1,2,3,0.75,0,0.000375,0.004256,0.003635
2620,7E439700,1,0,1,0,0,0.001478,0,0.005559
2621,7A4C8384,1,0,1,0,0,0,0,0.003635
2622,7C90ACF1,1,0,1,0,0,0.000309,0,0.003635
2623,8046B9CD,0,1,1,1,0,0,0,0
2624,7E08D384,4,5,9,0.487179,52.5,0.004498,0.012333,0.014542
2625,7F1C9742,3,1,4,1,26,0.00155,0.000104,0.032123
2626,69DE2AED,1,0,1,0,0,0.000271,0,0.003635
2627,6C83C1D7,0,1,1,1,0,0,0,0
2628,80811475,1,0,1,0,0,0.000266,0,0.003635
2629,80AF0521,2,2,4,1,1.5,0.000036,0.000387,0.007271
2630,8166B51D,2,2,4,0.356436,68,0.000594,0.000519,0.009195
2631,8064854E,0,3,3,0.2875,0,0,0.00001,0
2632,5FCF3C82,4,0,4,0,0,0.015248,0,0.026711
2633,810995C5,4,0,4,0,0,0.000319,0,0.043075
2634,7C60E8D8,1,0,1,0,0,0.000767,0,0.003635
2635,7F7D7FFF,0,4,4,0.354167,0,0,0.070656,0
2636,80959DAF,0,3,3,0.5,0,0,0.00002,0
2637,75B1E390,3,0,3,0,0,0.001075,0,0.010906
2638,7D97BDF0,2,0,2,0,0,0.000076,0,0.007271
2639,78A44E9B,3,0,3,0,0,0.000738,0,0.010906
2640,7BA6F18A,0,3,3,0.404255,0,0,0.008386,0
2641,80934A94,0,2,2,1,0,0,0.001372,0
2642,80CF8033,0,7,7,0.486486,0,0,0.091039,0
2643,7CF5E87A,8,0,8,0,0,0.008137,0,0.048172
2644,036916A5,14,1,15,0.571429,204.316667,0.056213,0.000054,0.213675
2645,809D2175,0,2,2,1,0,0,0.006859,0
2646,7EB4C0E1,0,3,3,0.6,0,0,0.015813,0
2647,80B33E85,0,2,2,0.583333,0,0,0.00006,0
2648,7E007075,1,0,1,0,0,0.000852,0,0.003635
2649,77305E6A,1,0,1,0,0,0.001532,0,0.005559
2650,80B43123,0,3,3,0.8,0,0,0.001356,0
2651,0693BB8C,2,3,5,0.714286,71,0.016456,0.002721,0.03145
2652,5F573271,1,0,1,0,0,0.009279,0,0.023377
2653,7D8AB2EC,0,1,1,0.6,0,0,0.000014,0
2654,7EDDC90A,0,1,1,0.666667,0,0,0.000534,0
2655,7F5D4C53,58,8,66,0.75,1431.4,0.161161,0.015663,0.319283
2656,7D78CC5A,0,4,4,0.464286,0,0,0.004306,0
2657,07C12062,0,1,1,0.666667,0,0,0,0
2658,7D0C0E23,0,3,3,0.484848,0,0,0.033888,0
2659,7D9F1460,1,0,1,0,0,0,0,0.003635
2660,75AE25D1,1,0,1,0,0,0.009279,0,0.023377
2661,7F869C46,1,2,3,0.466667,14,0.000482,0.013835,0.003635
2662,7D0BCD94,0,7,7,0.347826,0,0,0.021856,0
2663,7DE69E3B,0,1,1,1,0,0,0,0
2664,773890D0,1,0,1,0,0,0.016102,0,0.019026
2665,7ED1705C,0,7,7,0.326633,0,0,0.074035,0
2666,7E80013F,0,2,2,1,0,0,0.000048,0
2667,7EC370D0,0,1,1,1,0,0,0.000055,0
2668,7F54C791,2,0,2,0,0,0.001287,0,0.009195
2669,802C6E80,1,1,2,1,1,0.000736,0.00054,0.003635
2670,7E48334E,0,3,3,0.5,0,0,0.011745,0
2671,7FE00400,1,4,5,0.5,8.5,0,0.006134,0.003635
2672,7DF62E8E,9,3,12,1,49.666667,0.035148,0.010385,0.064506
2673,8038FFAC,3,1,4,1,4,0.000842,0.000006,0.016678
2674,78C849C9,1,3,4,0.6,6,0.000599,0.083357,0.003635
2675,7FC44A3C,0,2,2,0.361111,0,0,0.000955,0
2676,813C4093,2,0,2,0,0,0,0,0.007271
2677,7FAC94C7,0,8,8,0.322148,0,0,0.013311,0
2678,81690DBA,1,1,2,1,0,0.00048,0.000149,0.005559
2679,7583E4BC,7,0,7,0,0,0.006335,0,0.038849
2680,7FB34CD0,0,2,2,0.466667,0,0,0.027653,0
2681,7F7730E0,4,0,4,0,0,0.017683,0,0.044886
2682,7EB99DDA,3,0,3,0,0,0.000245,0,0.01283
2683,77CC4FDB,0,2,2,1,0,0,0.00081,0
2684,80F46DEC,0,2,2,0.355769,0,0,0.002085,0
2685,7DEC37AA,0,6,6,0.485714,0,0,0.003627,0
2686,7CD61845,1,4,5,0.433962,16.5,0.000519,0.006081,0.003635
2687,81050029,1,0,1,0,0,0.000462,0,0.003635
2688,809E85C2,1,6,7,0.619048,13,0.000011,0.013637,0.003635
2689,06C490A2,4,0,4,0,0,0.003063,0,0.014542
2690,7F502B23,4,0,4,0,0,0.003445,0,0.025168
2691,7D56C0AA,1,2,3,1,2,0,0,0.003635
2692,59340937,1,0,1,0,0,0.000471,0,0.008187
2693,60505B9F,5,0,5,0,0,0.000107,0,0.038269
2694,5F6F8C68,1,0,1,0,0,0.000001,0,0.003635
2695,7855C58D,0,2,2,0.5,0,0,0,0
2696,80397A89,0,1,1,0.571429,0,0,0,0
2697,750B5203,1,2,3,0.75,12,0.000173,0.006289,0.00615
2698,75F0F595,3,0,3,0,0,0.011485,0,0.010906
2699,7E6F2FCF,0,3,3,0.8,0,0,0.005725,0
2700,7DAEBBEA,0,3,3,0.4,0,0,0.000446,0
2701,5A0F1022,1,0,1,0,0,0,0,0.003635
2702,813735CE,7,1,8,1,21,0.010251,0,0.04445
2703,7F239D7F,0,3,3,0.375,0,0,0.000864,0
2704,64216735,0,2,2,0.448276,0,0,0.000737,0
2705,5B03F774,0,1,1,0.242991,0,0,0.000049,0
2706,686788D4,5,0,5,0,0,0.001638,0,0.03553
2707,7BF12A47,0,2,2,0.34,0,0,0.000078,0
2708,78D5B99A,0,1,1,0.666667,0,0,0,0
2709,58CF9412,5,5,10,0.454545,102.166667,0.004292,0.030402,0.06184
2710,7F6D095C,0,5,5,0.5,0,0,0.007965,0
2711,7EFEE2D0,2,0,2,0,0,0,0,0.009195
2712,7AB14D78,2,3,5,0.418605,27.333333,0.006988,0.013192,0.007271
2713,59C847F7,1,0,1,0,0,0,0,0.003635
2714,7867DABC,0,2,2,0.666667,0,0,0.068111,0
2715,7FD002CC,1,1,2,1,1,0.000005,0,0.003635
2716,7890DEC7,0,2,2,0.75,0,0,0.070952,0
2717,80E04BB6,0,1,1,1,0,0,0.000312,0
2718,7FB445F6,4,5,9,0.5,719.833333,0.012698,0.033902,0.064801
2719,7D9C70B9,0,1,1,1,0,0,0.001137,0
2720,75D21B47,1,0,1,0,0,0.001316,0,0.003635
2721,76CF910C,1,0,1,0,0,0,0,0.003635
2722,5C3BC2B2,1,0,1,0,0,0.006022,0,0.003635
2723,7F031488,5,1,6,1,4,0.005957,0.000495,0.02972
2724,7EBD79FA,0,1,1,1,0,0,0.00424,0
2725,7B9ABEDC,1,0,1,0,0,0.006473,0,0.003635
2726,80ED5AF2,1,0,1,0,0,0.006449,0,0.003635
2727,7D8B0523,1,1,2,1,0,0,0,0.003635
2728,7EF13637,1,0,1,0,0,0.000005,0,0.005559
2729,7FD544BB,0,3,3,0.483871,0,0,0.029309,0
2730,76E93BC4,1,0,1,0,0,0,0,0.003635
2731,7CCF0818,3,19,22,0.347015,185.490476,0.002927,0.058475,0.010906
2732,7D1B5C3E,1,5,6,0.277457,42,0.000025,0.004478,0.003635
2733,79A66971,1,0,1,0,0,0.000018,0,0.003635
2734,81656415,0,1,1,0.448276,0,0,0.013735,0
2735,7F45025E,0,2,2,0.349057,0,0,0.001082,0
2736,807295D6,2,7,9,0.888889,16,0.000258,0.007561,0.007271
2737,817919B4,0,2,2,1,0,0,0.006318,0
2738,5B1ABC02,1,0,1,0,0,0,0,0.003635
2739,7BAF0410,0,9,9,0.5,0,0,0.118058,0
2740,80E4A35F,1,0,1,0,0,0,0,0.003635
2741,7EF1047D,9,0,9,0,0,0.016405,0,0.050536
2742,828381CE,0,1,1,1,0,0,0.004826,0
2743,803B48FC,3,0,3,0,0,0.00167,0,0.01283
2744,7E8C332A,5,0,5,0,0,0.000081,0,0.062334
2745,7E0D9B92,2,4,6,0.375,31.5,0.000159,0.002755,0.007271
2746,803CCC1D,3,0,3,0,0,0.000026,0,0.010906
2747,7E27AD3A,0,2,2,0.666667,0,0,0.000508,0
2748,053CA3B0,0,10,10,0.8,0,0,0.003185,0
2749,5D137E15,1,0,1,0,0,0.00208,0,0.003635
2750,77212DD7,1,6,7,0.8,5.5,0.005685,0.002206,0.003635
2751,5F7915F3,2,0,2,0,0,0.00012,0,0.009195
2752,59EC91EB,6,0,6,0,0,0.002971,0,0.208299
2753,7E290932,0,2,2,0.428571,0,0,0.002316,0
2754,7D070A1C,0,1,1,1,0,0,0.000006,0
2755,7EA4652A,3,0,3,0,0,0.005694,0,0.014754
2756,5B7C40CF,1,0,1,0,0,0,0,0.003635
2757,750F0146,1,0,1,0,0,0.016102,0,0.019026
2758,7C1C0455,0,9,9,0.315412,0,0,0.081248,0
2759,7DE6ACC6,1,1,2,1,1,0,0,0.003635
2760,79F52EAA,0,1,1,1,0,0,0.000021,0
2761,7DE0DD9B,1,2,3,0.393443,46,0.005941,0.00763,0.005559
2762,7F73B6FC,0,1,1,1,0,0,0.000066,0
2763,7E91E8D9,2,2,4,0.307692,20,0.000636,0.005407,0.007271
2764,5980C433,1,1,2,1,1,0,0.003126,0.003635
2765,7D9380B1,0,1,1,1,0,0,0,0
2766,8050D2BC,0,1,1,1,0,0,0,0
2767,807A67C4,0,1,1,1,0,0,0.001594,0
2768,740BAEDD,1,0,1,0,0,0.001188,0,0.007483
2769,7C0EA52C,0,16,16,0.319936,0,0,0.024404,0
2770,7E23C091,0,1,1,1,0,0,0.006272,0
2771,5906607E,0,2,2,0.470588,0,0,0.005785,0
2772,7CF27936,0,2,2,1,0,0,0.000149,0
2773,8136EC9C,3,2,5,1,6,0.0089,0.002314,0.01283
2774,803FF7C8,1,0,1,0,0,0.000304,0,0.003635
2775,781017E6,1,1,2,0.352941,7,0,0,0.005559
2776,7D99EE24,0,4,4,0.484848,0,0,0.003917,0
2777,32DE4EBC,0,3,3,0.362745,0,0,0.013769,0
2778,7D917D0B,0,3,3,0.5,0,0,0.000772,0
2779,7FFE579A,1,0,1,0,0,0,0,0.003635
2780,05911E73,1,0,1,0,0,0.000021,0,0.00615
