Id,Label,indegree,outdegree,Degree,closnesscentrality,betweenesscentrality,Authority,Hub,eigencentrality
0,75D7C029,0,5,5,1,0,0,0.000144,0
1,80CDA5B4,1,0,1,0,0,0,0,0.006286
2,7E6BD1C8,0,1,1,1,0,0,0.00019,0
3,78E93AC4,0,3,3,0.8,0,0,0.00014,0
4,7C7C50E6,0,3,3,0.6,0,0,0.000136,0
5,7ECE76F2,0,1,1,0.6,0,0,0.007839,0
6,791D3F75,2,1,3,1,2,0.000014,0,0.012573
7,7E4F0BCC,0,1,1,1,0,0,0.047704,0
8,7B3E9851,1,0,1,0,0,0,0,0.006286
9,783187B2,0,2,2,1,0,0,0,0
10,7DC1284B,0,1,1,1,0,0,0,0
11,7FAD3992,3,0,3,0,0,0.000778,0,0.029422
12,77FF377C,0,2,2,1,0,0,0.000019,0
13,75DC659B,1,1,2,0.444444,4,0,0,0.006286
14,7CBFE3A8,1,0,1,0,0,0,0,0.006286
15,818543D5,1,0,1,0,0,0,0,0.006286
16,7E687058,0,1,1,1,0,0,0,0
17,7EF225FE,0,2,2,0.75,0,0,0.000005,0
18,80C1D0AD,0,2,2,0.75,0,0,0.091094,0
19,779865A2,1,3,4,0.8,3,0.009823,0.01249,0.006286
20,7D0DCE29,9,1,10,1,1,0.000032,0.00003,0.08518
21,7863ABE4,4,0,4,0,0,0.00082,0,0.025146
22,76A25FEA,3,0,3,0,0,0,0,0.024141
23,8064EACE,1,2,3,1,1,0,0.000002,0.006286
24,7F969FB7,0,1,1,1,0,0,0,0
25,7703F641,0,1,1,0.6,0,0,0.007839,0
26,7ECD1AA6,0,1,1,1,0,0,0,0
27,81207731,2,4,6,0.636364,12,0.014409,0.00669,0.012573
28,80FA4652,0,1,1,1,0,0,0.000968,0
29,79DFB5F0,2,1,3,0.666667,4,0,0.002418,0.012573
30,79E19BD9,0,2,2,0.6,0,0,0,0
31,80229734,0,1,1,1,0,0,0,0
32,75A4B71B,0,3,3,0.571429,0,0,0.000014,0
33,7869D471,8,2,10,1,23,0,0,0.078003
34,7BB269DB,0,1,1,0.5,0,0,0.000001,0
35,794EA69D,0,1,1,1,0,0,0.000017,0
36,7C095333,0,1,1,1,0,0,0,0
37,75F1F2C7,2,0,2,0,0,0.001271,0,0.035439
38,7C089058,0,2,2,0.75,0,0,0.000023,0
39,797E25D4,0,2,2,1,0,0,0,0
40,777C884F,0,1,1,1,0,0,0,0
41,767E1F00,0,1,1,1,0,0,0,0
42,7BB6EEB7,4,0,4,0,0,0.00001,0,0.030427
43,80FA3E75,2,1,3,1,5,0.000247,0.047704,0.030612
44,7EF529F7,1,0,1,0,0,0,0,0.006286
45,7A8F6DD5,4,0,4,0,0,0.000003,0,0.025146
46,7FC4C0C4,2,1,3,0.6,9,0,0,0.017854
47,799F491A,0,1,1,0.666667,0,0,0,0
48,0E9D5713,0,1,1,0.571429,0,0,0,0
49,7E42775D,0,2,2,0.75,0,0,0.000137,0
50,7BFBB179,0,1,1,1,0,0,0.08476,0
51,80E3ED33,0,1,1,1,0,0,0.000014,0
52,7842C6AB,0,1,1,0.666667,0,0,0,0
53,77CFFBEA,3,1,4,1,2,0.000001,0,0.018859
54,75CD0590,0,2,2,0.411765,0,0,0,0
55,80D5FEE3,0,1,1,1,0,0,0,0
56,7A305B66,0,3,3,1,0,0,0,0
57,381EEB60,5,0,5,0,0,0,0,0.041995
58,7F157EE1,1,0,1,0,0,0,0,0.011568
59,80AAB33B,1,1,2,1,0.5,0.000058,0.00061,0.006286
60,7BBBA172,1,0,1,0,0,0.000154,0,0.006286
61,6DDF67D5,0,1,1,1,0,0,0,0
62,7D5C56B2,0,1,1,1,0,0,0.002008,0
63,79F6DD04,0,2,2,0.555556,0,0,0,0
64,7B7BBC41,0,2,2,0.75,0,0,0,0
65,8018CB33,1,0,1,0,0,0,0,0.006286
66,7A8C3B36,0,6,6,0.47619,0,0,0.022265,0
67,76CB032E,0,1,1,0.666667,0,0,0.002418,0
68,75CBD394,0,1,1,0.666667,0,0,0,0
69,7667F538,1,1,2,1,1,0,0,0.006286
70,807C1C5F,0,5,5,0.419355,0,0,0.000001,0
71,7CBCA551,0,1,1,1,0,0,0,0
72,7BD678E2,4,0,4,0,0,0,0,0.061225
73,7E6A0E33,1,0,1,0,0,0,0,0.006286
74,7FEF87E9,1,0,1,0,0,0,0,0.011568
75,5BA1287D,0,1,1,1,0,0,0,0
76,756379A8,1,0,1,0,0,0,0,0.006286
77,7C86BB13,1,0,1,0,0,0,0,0.006286
78,7511C004,3,1,4,0.6,10,0,0,0.029422
79,7C4A40C6,0,2,2,0.666667,0,0,0.000122,0
80,7A573FFE,0,1,1,1,0,0,0.047704,0
81,7D1867F0,1,0,1,0,0,0,0,0.006286
82,7A94F391,1,1,2,1,0,0.004882,0.047704,0.006286
83,7855D597,2,0,2,0,0,0,0,0.017854
84,8097C64D,0,1,1,1,0,0,0,0
85,76E7BA42,0,1,1,0.666667,0,0,0,0
86,5E798409,5,0,5,0,0,0.000017,0,0.036714
87,7986E10A,0,2,2,1,0,0,0.000085,0
88,7B1EE889,1,0,1,0,0,0,0,0.006286
89,79B79D87,1,0,1,0,0,0,0,0.006286
90,786A6C47,0,2,2,0.75,0,0,0.000589,0
91,79ED5322,4,0,4,0,0,0.000503,0,0.025146
92,7D01A9B2,0,2,2,0.625,0,0,0,0
93,79679C05,0,1,1,1,0,0,0.08476,0
94,76554468,8,1,9,1,10,0.000914,0,0.087675
95,7F510A59,1,1,2,1,1.5,0,0,0.011568
96,7B923FE5,1,0,1,0,0,0.008585,0,0.006286
97,75B09827,0,1,1,1,0,0,0,0
98,75B315DE,0,2,2,1,0,0,0,0
99,7B6CD65F,0,1,1,1,0,0,0,0
100,7CB797CE,2,0,2,0,0,0.00001,0,0.017854
101,8139F50D,0,2,2,0.75,0,0,0.006398,0
102,760D3D78,0,1,1,1,0,0,0,0
103,8168398A,1,0,1,0,0,0,0,0.006286
104,81CAD12D,0,2,2,0.293103,0,0,0.000968,0
105,7D1F87D1,0,7,7,0.888889,0,0,0.018611,0
106,80EFE0BC,1,4,5,0.571429,3,0,0.000012,0.006286
107,759606E5,0,1,1,0.5,0,0,0.000001,0
108,76640244,0,1,1,1,0,0,0.047704,0
109,7ADE322B,0,1,1,1,0,0,0,0
110,8108E51D,1,0,1,0,0,0,0,0.006286
111,7DAF58C1,0,2,2,0.666667,0,0,0.002761,0
112,806C982A,1,1,2,1,1,0,0,0.006286
113,80C1E84B,2,0,2,0,0,0.01573,0,0.046457
114,7A539D2C,3,2,5,0.75,18,0.00001,0.000093,0.045266
115,7CC3B576,0,1,1,1,0,0,0.08476,0
116,26150FB2,0,1,1,1,0,0,0,0
117,7CEFBDC2,1,0,1,0,0,0,0,0.006286
118,70FB58C5,1,1,2,1,1,0.000012,0.000001,0.006286
119,7A85A3B4,0,2,2,1,0,0,0,0
120,03D39E77,0,1,1,1,0,0,0,0
121,78F2BE2F,1,0,1,0,0,0.000002,0,0.006286
122,759EF9D0,1,0,1,0,0,0,0,0.011568
123,7D30BB0D,1,0,1,0,0,0,0,0.006286
124,7DAC42F8,2,0,2,0,0,0.011647,0,0.023136
125,600C6FA8,4,0,4,0,0,0,0,0.025146
126,7AD43373,1,0,1,0,0,0,0,0.006286
127,76417038,0,2,2,1,0,0,0.01477,0
128,770E6DF6,0,1,1,0.461538,0,0,0.000099,0
129,7F00D0B0,9,0,9,0,0,0.006086,0,0.119064
130,80B6FFB6,1,2,3,1,8,0,0.002029,0.019045
131,751967EE,0,1,1,0.5,0,0,0,0
132,7CEB6F11,0,4,4,1,0,0,0.000217,0
133,7FE2B239,1,0,1,0,0,0.00021,0,0.006286
134,803D822B,15,0,15,0,0,0.020027,0,0.341598
135,790C12A3,0,1,1,1,0,0,0,0
136,79B37621,1,1,2,1,1,0,0.000002,0.006286
137,775D228E,0,2,2,1,0,0,0.000004,0
138,7ED5824E,1,0,1,0,0,0,0,0.006286
139,79AAFCF5,12,0,12,0,0,0.031988,0,0.436422
140,7BC708E3,1,0,1,0,0,0,0,0.011568
141,7BED8C10,0,2,2,1,0,0,0.132464,0
142,5AE0E4A9,3,0,3,0,0,0,0,0.018859
143,7C745283,1,0,1,0,0,0,0,0.006286
144,7EC20BF2,1,0,1,0,0,0,0,0.006286
145,7B94CB38,0,1,1,1,0,0,0,0
146,5E8246AB,1,0,1,0,0,0,0,0.006286
147,78631135,0,1,1,1,0,0,0.000002,0
148,7E96A866,0,1,1,1,0,0,0,0
149,7A417820,1,0,1,0,0,0,0,0.006286
150,63B84A19,0,2,2,0.555556,0,0,0.000001,0
151,787F9DB6,5,1,6,1,9,0.000111,0,0.103013
152,7A52F222,2,2,4,1,3,0,0.000004,0.012573
153,77CAC746,0,1,1,1,0,0,0.000011,0
154,75AA5F7F,0,1,1,1,0,0,0,0
155,7F4146E0,0,1,1,1,0,0,0,0
156,837822B7,1,3,4,1,3,0,0.000998,0.006286
157,7A36DCCF,0,1,1,1,0,0,0.001331,0
158,788AB29E,0,1,1,1,0,0,0.000018,0
159,7B7C180C,2,0,2,0,0,0,0,0.012573
160,7A14F026,0,3,3,0.5,0,0,0.000004,0
161,7D3C6025,2,0,2,0,0,0,0,0.037244
162,7C5F5AB9,0,1,1,1,0,0,0.000002,0
163,78DA1A60,2,0,2,0,0,0,0,0.012573
164,79B36A21,2,0,2,0,0,0.000247,0,0.012573
165,77E57AC1,0,1,1,1,0,0,0,0
166,7BA809AF,2,6,8,1,12.833333,0.017053,0.017629,0.069778
167,7BBBEE0B,1,0,1,0,0,0,0,0.006286
168,789030BF,1,0,1,0,0,0,0,0.006286
169,7A2439B8,1,0,1,0,0,0,0,0.006286
170,79F8471E,0,1,1,0.666667,0,0,0.000023,0
171,7EA4FA77,0,1,1,0.6,0,0,0,0
172,811B2F65,1,0,1,0,0,0,0,0.006286
173,791C330D,0,3,3,0.8,0,0,0,0
174,761A29B7,0,5,5,0.555556,0,0,0.000024,0
175,7AF167DD,0,2,2,1,0,0,0.000014,0
176,781317BA,0,1,1,0.411765,0,0,0,0
177,7588FD73,0,2,2,1,0,0,0,0
178,7886251B,0,2,2,0.526316,0,0,0,0
179,8435EF7C,0,2,2,1,0,0,0.048189,0
180,784ABC4A,0,1,1,0.5,0,0,0,0
181,807B616C,0,2,2,0.545455,0,0,0.000168,0
182,75D45B2E,0,1,1,0.5,0,0,0,0
183,7CFE1E3C,1,0,1,0,0,0,0,0.006286
184,80223832,1,0,1,0,0,0,0,0.006286
185,7E9B4798,1,0,1,0,0,0,0,0.006286
186,7C10F7EA,0,1,1,1,0,0,0,0
187,7EE0C9B0,0,1,1,1,0,0,0.000011,0
188,8034BE04,23,0,23,0,0,0.000138,0,0.222028
189,7AA5BE88,9,0,9,0,0,0.000011,0,0.12215
190,7F3B4097,0,1,1,1,0,0,0.00005,0
191,7E98D1D2,4,0,4,0,0,0.025399,0,0.025146
192,7EB23F47,1,0,1,0,0,0,0,0.006286
193,7DEC282B,0,1,1,1,0,0,0,0
194,7AD14559,2,0,2,0,0,0,0,0.017854
195,76C9EEDA,1,0,1,0,0,0,0,0.006286
196,7E3719FA,3,0,3,0,0,0,0,0.018859
197,762938B5,0,3,3,0.625,0,0,0,0
198,78E15D8C,1,0,1,0,0,0.013417,0,0.006286
199,7C1A43CC,0,1,1,1,0,0,0,0
200,77E07D1D,0,4,4,0.75,0,0,0,0
201,7BD64644,0,1,1,1,0,0,0,0
202,106F15D3,1,0,1,0,0,0,0,0.006286
203,7BCBE2F0,1,0,1,0,0,0.000089,0,0.006286
204,76B6B8A8,2,0,2,0,0,0.001786,0,0.051574
205,795BD6C4,1,1,2,0.416667,5,0,0,0.006286
206,80367FCF,3,0,3,0,0,0,0,0.036899
207,75E7F6FF,0,1,1,0.6,0,0,0,0
208,77C687DB,1,0,1,0,0,0,0,0.006286
209,83DBD7F2,1,0,1,0,0,0,0,0.006286
210,754BA754,0,1,1,1,0,0,0,0
211,7F95BB86,0,2,2,1,0,0,0.000616,0
212,795D252B,1,0,1,0,0,0,0,0.006286
213,77A8CDB6,1,1,2,1,1,0.000005,0,0.006286
214,79B505DA,0,1,1,1,0,0,0,0
215,761F3059,0,2,2,0.454545,0,0,0.000002,0
216,76BC01CC,1,0,1,0,0,0,0,0.006286
217,7DA73B6B,1,0,1,0,0,0.004832,0,0.006286
218,78485DC1,1,0,1,0,0,0,0,0.006286
219,789D3533,0,2,2,0.4375,0,0,0.004864,0
220,7D707B95,0,2,2,1,0,0,0.000019,0
221,7F039782,2,0,2,0,0,0,0,0.012573
222,787B47D7,0,2,2,0.75,0,0,0.001671,0
223,784B6751,1,1,2,0.5,0,0,0,0.006286
224,7BBEC73A,2,2,4,0.75,3,0,0.000018,0.017854
225,807239CB,3,1,4,1,2,0.001602,0.002008,0.029422
226,00874FEF,0,3,3,1,0,0,0.000034,0
227,7B520827,1,0,1,0,0,0,0,0.006286
228,76701EA0,1,1,2,0.666667,2,0,0,0.006286
229,7E085B30,2,1,3,1,0.5,0,0,0.017854
230,789593A3,3,1,4,0.411765,28,0,0,0.024141
231,76AD9062,1,1,2,1,1,0,0.000014,0.006286
232,7EC89E25,1,1,2,0.666667,2,0,0,0.006286
233,7DA310E6,2,1,3,1,2,0,0.000026,0.012573
234,75D226E3,0,2,2,1,0,0,0.000015,0
235,7627E81C,1,0,1,0,0,0,0,0.006286
236,7797D9CA,0,1,1,1,0,0,0,0
237,5878569A,1,0,1,0,0,0.000002,0,0.006286
238,77AEB923,6,2,8,1,4.833333,0.046923,0.055093,0.043
239,7A1052E2,1,0,1,0,0,0,0,0.006286
240,7569E584,2,0,2,0,0,0,0,0.017854
241,7859D99B,2,0,2,0,0,0,0,0.023136
242,7C56291C,0,2,2,0.75,0,0,0.055543,0
243,7C83EBF2,0,1,1,0.4,0,0,0.000001,0
244,7ACFC23B,0,3,3,1,0,0,0.133809,0
245,7DC4F974,0,1,1,1,0,0,0,0
246,77A0A459,2,1,3,1,0.5,0.013697,0.08476,0.023136
247,784E1976,1,0,1,0,0,0,0,0.006286
248,7EB600C6,0,3,3,0.6,0,0,0.000023,0
249,7ABA2AF9,2,1,3,0.666667,3,0.015775,0,0.017854
250,76C3996A,0,4,4,0.75,0,0,0.000001,0
251,7CE92D8C,0,1,1,0.666667,0,0,0.006334,0
252,792A607A,0,2,2,0.666667,0,0,0.000123,0
253,7AC331B2,0,4,4,0.7,0,0,0.007443,0
254,7E2904C9,0,1,1,0.666667,0,0,0.006334,0
255,76B2B573,5,0,5,0,0,0,0,0.057839
256,802A166E,0,1,1,1,0,0,0,0
257,8117B53C,0,1,1,1,0,0,0.000001,0
258,7EF9725E,1,4,5,0.7,4,0.00495,0.063177,0.006286
259,784DF927,0,3,3,0.583333,0,0,0,0
260,751F8CF9,1,3,4,1,3,0,0,0.006286
261,7DA7F3D8,0,1,1,1,0,0,0,0
262,7C25891A,1,0,1,0,0,0,0,0.006286
263,76EC9601,1,0,1,0,0,0,0,0.006286
264,75E77FAE,0,1,1,1,0,0,0,0
265,7A6DAEF6,6,0,6,0,0,0.015699,0,0.055758
266,77429A35,0,4,4,0.5,0,0,0.000233,0
267,7FC0C78E,13,1,14,0.666667,17.5,0.000007,0,0.120889
268,7CED1964,0,1,1,1,0,0,0.000004,0
269,765067F1,0,1,1,1,0,0,0,0
270,759B8408,0,1,1,1,0,0,0,0
271,75C4E0C2,0,1,1,0.4,0,0,0,0
272,7AFD712A,1,1,2,0.428571,0,0.000002,0,0.006286
273,7A8E1774,0,2,2,0.75,0,0,0.048194,0
274,7A01FB33,1,3,4,0.8,2,0.013558,0.140303,0.006286
275,7FC77EA6,1,0,1,0,0,0.000642,0,0.006286
276,7B9B1F91,1,0,1,0,0,0,0,0.011568
277,7DC530A8,0,1,1,1,0,0,0.001651,0
278,7A24DBE6,0,1,1,1,0,0,0,0
279,7B3D2D5B,3,1,4,0.666667,6,0,0.003396,0.018859
280,7800DAE4,18,0,18,0,0,0.121901,0,0.294613
281,7C1C3548,0,2,2,1,0,0,0.048189,0
282,7B09613A,1,1,2,1,1,0.000394,0.00249,0.006286
283,7BC05133,1,1,2,1,2,0,0.000489,0.011568
284,773D64A3,0,1,1,1,0,0,0,0
285,7C9896C1,0,2,2,0.428571,0,0,0.000001,0
286,7FFC4CBF,0,2,2,1,0,0,0,0
287,79BD7C48,1,0,1,0,0,0,0,0.006286
288,780842DC,0,1,1,1,0,0,0.000026,0
289,7929300D,0,1,1,1,0,0,0,0
290,787FB439,5,0,5,0,0,0,0,0.094833
291,7A3542D5,0,2,2,1,0,0,0,0
292,77CD3968,0,2,2,0.5,0,0,0,0
293,77B043F6,0,1,1,1,0,0,0.001651,0
294,774D15BA,0,6,6,0.472222,0,0,0.000097,0
295,7747E4EA,1,0,1,0,0,0,0,0.006286
296,758FD46B,0,3,3,0.571429,0,0,0.004497,0
297,79263CAF,0,3,3,0.8,0,0,0.001002,0
298,7D481E87,0,3,3,0.714286,0,0,0.000013,0
299,8008D5C1,2,4,6,0.5625,14,0.00066,0.000456,0.017854
300,5A17B5F4,2,0,2,0,0,0,0,0.012573
301,80A3897C,3,0,3,0,0,0,0,0.029422
302,7A68D053,1,0,1,0,0,0.008679,0,0.006286
303,780ABBB3,0,2,2,1,0,0,0,0
304,7611E4A0,0,1,1,1,0,0,0,0
305,78F07DFA,1,1,2,0.666667,0.5,0.000016,0.006334,0.006286
306,77CFBD75,1,2,3,1,2,0,0,0.006286
307,77A55142,0,1,1,1,0,0,0,0
308,815ADEFC,0,1,1,1,0,0,0,0
309,8013DBE0,3,0,3,0,0,0.000152,0,0.031618
310,78457887,2,1,3,1,2,0.000006,0.000014,0.012573
311,7E53BB21,0,1,1,1,0,0,0.08476,0
312,7907D102,5,0,5,0,0,0.000039,0,0.041995
313,80E8792D,3,1,4,1,0.5,0,0,0.047173
314,8136FCFA,1,0,1,0,0,0,0,0.011568
315,7BA8570E,0,3,3,0.8,0,0,0,0
316,7A196128,1,0,1,0,0,0,0,0.016849
317,7F2C73FF,5,0,5,0,0,0.000174,0,0.067511
318,7FC96E71,0,4,4,0.75,0,0,0.015768,0
319,7A83E2E8,1,0,1,0,0,0,0,0.006286
320,7875028D,0,8,8,0.722222,0,0,0.118973,0
321,7C4BBF98,0,2,2,0.75,0,0,0.000015,0
322,7A7F1E4E,3,7,10,0.5625,46.5,0.000035,0.00036,0.018859
323,7DA92E38,3,1,4,1,14,0,0.000028,0.132089
324,8549CE99,0,1,1,0.454545,0,0,0,0
325,781991F6,1,0,1,0,0,0,0,0.011568
326,58509D99,1,3,4,0.714286,8,0,0.000002,0.011568
327,80DDF623,0,2,2,1,0,0,0.096983,0
328,78563FBF,3,0,3,0,0,0,0,0.018859
329,8092EB86,1,0,1,0,0,0,0,0.006286
330,7D0F31A4,1,0,1,0,0,0,0,0.006286
331,795EA7E5,0,1,1,1,0,0,0.000001,0
332,5D5A16D4,1,3,4,0.538462,7,0,0,0.006286
333,7E9F82D0,3,0,3,0,0,0,0,0.018859
334,77974C63,0,1,1,1,0,0,0,0
335,7671E5C1,0,1,1,0.5,0,0,0,0
336,761FC4CF,2,1,3,1,0,0,0,0.012573
337,77BCEA61,0,1,1,1,0,0,0.000004,0
338,7614507A,0,2,2,1,0,0,0.132464,0
339,7DBB959E,0,2,2,1,0,0,0.000006,0
340,7E1CFD09,0,2,2,0.75,0,0,0.002443,0
341,7CB99C7D,1,0,1,0,0,0,0,0.006286
342,7E4D33B9,0,1,1,1,0,0,0,0
343,7D62E533,1,1,2,1,1,0,0,0.006286
344,75FB83E3,2,0,2,0,0,0.000475,0,0.044065
345,7C5017A2,0,1,1,1,0,0,0,0
346,8114BE80,0,2,2,0.75,0,0,0.052409,0
347,5D05C6D1,3,0,3,0,0,0,0,0.018859
348,789DB155,0,1,1,1,0,0,0,0
349,78D89F19,3,1,4,1,4,0.017401,0,0.029422
350,7BBCC099,3,0,3,0,0,0,0,0.024141
351,7A245DDF,1,0,1,0,0,0,0,0.006286
352,58D34417,0,1,1,1,0,0,0.001651,0
353,774822C2,0,5,5,1,0,0,0.001531,0
354,765FF3A1,0,3,3,1,0,0,0.000018,0
355,7DFDC455,1,0,1,0,0,0.000138,0,0.006286
356,7FAFBA63,0,1,1,1,0,0,0,0
357,7D4E550B,8,3,11,1,2,0.023904,0.011974,0.273993
358,75403DF6,1,4,5,0.833333,2,0,0,0.006286
359,7D652B6F,0,1,1,1,0,0,0,0
360,78A3025B,0,1,1,1,0,0,0.00005,0
361,7EADF9AB,0,1,1,1,0,0,0.08476,0
362,7DA1CA42,0,1,1,1,0,0,0,0
363,7C4CDC77,0,1,1,1,0,0,0,0
364,79822BCF,1,1,2,0.444444,4,0,0,0.006286
365,5DBB21BD,2,0,2,0,0,0.000754,0,0.012573
366,7B1E0639,14,0,14,0,0,0.042075,0,0.592894
367,75FAA384,0,1,1,1,0,0,0,0
368,7FBD2E0F,4,1,5,1,2,0.000001,0.000004,0.11303
369,7D3F501E,1,0,1,0,0,0,0,0.006286
370,78407F03,7,5,12,0.727273,88,0.000039,0.000021,0.088452
371,77D9240D,1,1,2,1,1,0.000746,0,0.006286
372,7CFC95E0,0,2,2,1,0,0,0.000094,0
373,7D3C2BD7,10,1,11,1,8,0.000226,0.000001,0.068146
374,81144E0E,0,1,1,0.4,0,0,0,0
375,77570542,0,1,1,1,0,0,0,0
376,7703E1C0,13,1,14,1,4.5,0.045348,0.004219,0.457373
377,7C888888,11,0,11,0,0,0.000283,0,0.160247
378,7DB0B8C5,1,0,1,0,0,0,0,0.006286
379,76D07F4B,0,2,2,0.75,0,0,0.002443,0
380,77A73F27,2,1,3,1,3.5,0.000009,0,0.039394
381,7BFF23E9,0,1,1,1,0,0,0,0
382,807EE75F,0,1,1,0.6,0,0,0.004705,0
383,7A4DA5F4,1,3,4,0.583333,6.5,0.00001,0,0.006286
384,7AA7CE9D,6,0,6,0,0,0.000258,0,0.048282
385,7398EDF1,0,1,1,1,0,0,0,0
386,7D27CC5E,0,2,2,0.583333,0,0,0.005287,0
387,7E320D6B,0,2,2,1,0,0,0.000014,0
388,805157C9,0,1,1,1,0,0,0,0
389,7FF0BA5A,3,0,3,0,0,0.000258,0,0.061257
390,7579D8DE,0,3,3,0.6,0,0,0,0
391,7F349CDF,2,4,6,1,3,0.002317,0.05606,0.012573
392,8020556A,1,0,1,0,0,0,0,0.006286
393,79B41FD7,2,0,2,0,0,0,0,0.02005
394,0296A7D0,0,3,3,1,0,0,0.000015,0
395,7C3D7135,1,0,1,0,0,0.000013,0,0.006286
396,7DE0247D,5,0,5,0,0,0.001636,0,0.113576
397,7BD527AF,1,1,2,1,0,0.008585,0.08476,0.006286
398,5CA1923E,0,1,1,1,0,0,0.08476,0
399,79EF7736,0,1,1,0.666667,0,0,0,0
400,7F5FDECA,0,2,2,1,0,0,0,0
401,777647BE,0,1,1,1,0,0,0,0
402,7E29F9BA,0,2,2,0.571429,0,0,0.000003,0
403,75DCD5E4,0,1,1,0.666667,0,0,0,0
404,7CDC1FE2,8,1,9,1,6.5,0.00562,0.00061,0.060855
405,79EBC86D,0,1,1,1,0,0,0.000014,0
406,777C6586,1,0,1,0,0,0,0,0.006286
407,3B843500,0,4,4,0.833333,0,0,0.140342,0
408,7C16EFCA,0,1,1,1,0,0,0,0
409,75DFA909,0,1,1,1,0,0,0,0
410,7A9BC2CE,0,1,1,1,0,0,0,0
411,7B7F3CE0,0,1,1,1,0,0,0,0
412,7AE256B7,0,2,2,1,0,0,0.001668,0
413,811ECB5B,0,1,1,1,0,0,0,0
414,756923FB,1,0,1,0,0,0,0,0.006286
415,80EC473A,1,0,1,0,0,0,0,0.011568
416,7D7B6717,0,1,1,1,0,0,0,0
417,7C29446F,1,0,1,0,0,0,0,0.006286
418,813C83DA,0,2,2,0.545455,0,0,0,0
419,7DBF9CE4,0,2,2,0.555556,0,0,0.000001,0
420,76C4E584,2,0,2,0,0,0,0,0.032808
421,7C0F34AE,0,3,3,1,0,0,0.000031,0
422,7C384AF0,1,3,4,0.478261,3,0.000008,0.006502,0.006286
423,7B698514,0,3,3,1,0,0,0,0
424,7A1E62F8,1,0,1,0,0,0,0,0.006286
425,7D374D1B,2,9,11,0.764706,11.666667,0.011989,0.114689,0.017854
426,7916EB9B,0,2,2,1,0,0,0,0
427,77AFE24A,1,0,1,0,0,0,0,0.006286
428,79FD7778,0,3,3,0.521739,0,0,0.000001,0
429,7535F195,0,1,1,1,0,0,0,0
430,77131821,5,0,5,0,0,0.009265,0,0.052558
431,7B37D69B,0,2,2,1,0,0,0.000024,0
432,803E253B,0,4,4,0.514286,0,0,0.005029,0
433,7639C0C6,4,1,5,0.45,4.5,0.000001,0.000004,0.030427
434,75E95907,2,0,2,0,0,0,0,0.012573
435,791ABAB7,0,1,1,0.416667,0,0,0,0
436,7919F58A,0,1,1,1,0,0,0,0
437,799E0C6C,0,3,3,0.8,0,0,0.001068,0
438,7E97AF5E,7,1,8,1,3,0.000012,0.000001,0.072319
439,6FC905CA,0,1,1,0.666667,0,0,0,0
440,793A2B52,1,0,1,0,0,0.000014,0,0.006286
441,76F23C35,0,1,1,0.666667,0,0,0,0
442,75126ED0,0,1,1,1,0,0,0.047704,0
443,8069619E,2,2,4,0.625,4.5,0,0.000001,0.017854
444,7744E09B,7,0,7,0,0,0.001018,0,0.080155
445,7F2FA7CA,1,0,1,0,0,0,0,0.011568
446,7877038A,6,7,13,0.818182,44,0.000004,0.001031,0.079079
447,7F04CC81,1,0,1,0,0,0,0,0.006286
448,80771C93,0,1,1,1,0,0,0.000004,0
449,7C121A85,2,0,2,0,0,0,0,0.017854
450,7BAFEA03,0,3,3,0.454545,0,0,0.137279,0
451,7F0565D9,2,0,2,0,0,0.000199,0,0.025331
452,807A90BE,0,1,1,1,0,0,0,0
453,79F2E917,1,2,3,1,0,0.000261,0.002573,0.006286
454,7D785F33,1,0,1,0,0,0,0,0.006286
455,810569B5,1,0,1,0,0,0,0,0.006286
456,76A356BB,2,2,4,0.75,5,0.000078,0.006944,0.012573
457,79B62D11,0,1,1,1,0,0,0.00061,0
458,7F665F1C,1,0,1,0,0,0,0,0.006286
459,7CE57D60,9,0,9,0,0,0.000115,0,0.211337
460,787DDF83,0,1,1,1,0,0,0.000028,0
461,78F452ED,7,6,13,1,28.5,0.028608,0.105457,0.069521
462,76D17534,0,2,2,1,0,0,0,0
463,7DA582C5,1,0,1,0,0,0,0,0.006286
464,7DE7AE12,2,0,2,0,0,0,0,0.012573
465,758E6A8C,1,1,2,1,1,0.000001,0.000004,0.006286
466,77F4CAF8,0,1,1,0.5,0,0,0.000001,0
467,8121BCF1,0,2,2,0.75,0,0,0.085621,0
468,7C2EB46A,1,0,1,0,0,0,0,0.006286
469,78C3E729,1,0,1,0,0,0,0,0.006286
470,7B4843CC,1,1,2,0.666667,6,0,0.002418,0.016849
471,7E2F16D8,0,1,1,1,0,0,0,0
472,7F336EF7,0,3,3,1,0,0,0.000071,0
473,79082622,0,2,2,1,0,0,0,0
474,7E45BA69,1,1,2,0.666667,2,0.000167,0.000161,0.006286
475,7B82FBF2,0,1,1,1,0,0,0,0
476,76BAEA11,1,8,9,0.9,5.5,0.00738,0.067999,0.063491
477,80E77ADC,0,1,1,1,0,0,0,0
478,7AD844AD,0,2,2,1,0,0,0.001668,0
479,764FA4F7,0,2,2,0.555556,0,0,0,0
480,7B2D3282,0,1,1,1,0,0,0,0
481,7E8D0FFF,0,1,1,1,0,0,0,0
482,7F635C9F,3,0,3,0,0,0.000217,0,0.024141
483,77B3BAFF,0,2,2,0.666667,0,0,0.007921,0
484,7CF01DFF,1,0,1,0,0,0,0,0.006286
485,7B5F4744,0,2,2,0.38,0,0,0.000187,0
486,771FC1FA,1,1,2,1,0.5,0,0,0.006286
487,76F7A673,1,0,1,0,0,0,0,0.006286
488,788CC46B,0,1,1,0.6,0,0,0,0
489,75F2179D,0,2,2,1,0,0,0.085621,0
490,7E6198EC,0,1,1,1,0,0,0,0
491,7ED7823C,0,1,1,0.666667,0,0,0,0
492,79C4F23B,1,1,2,1,1,0,0,0.006286
493,7885E9D1,0,1,1,1,0,0,0,0
494,7ABED11A,3,0,3,0,0,0,0,0.024141
495,790BD9E0,1,2,3,1,1,0,0,0.006286
496,7A9D27BC,0,2,2,0.75,0,0,0,0
497,7CA82876,0,4,4,0.518519,0,0,0.006538,0
498,7EC175C3,4,5,9,1,47,0.000789,0.00249,0.053459
499,7FCBC03A,2,1,3,1,0,0.000274,0.001331,0.012573
500,8052A02B,0,1,1,0.666667,0,0,0,0
501,7D5A775F,0,1,1,1,0,0,0,0
502,75B643A5,0,2,2,1,0,0,0.000033,0
503,7651E411,0,1,1,1,0,0,0.000102,0
504,782F6F31,0,1,1,1,0,0,0,0
505,7DE879FB,0,2,2,0.75,0,0,0,0
506,7FCF57B6,0,1,1,1,0,0,0.001331,0
507,791C8D38,0,2,2,0.555556,0,0,0.085621,0
508,71136DE6,1,0,1,0,0,0,0,0.006286
509,7AA76061,1,0,1,0,0,0,0,0.006286
510,7EF1C99C,1,3,4,1,2,0.000167,0.134115,0.006286
511,799DA2E1,1,0,1,0,0,0.000062,0,0.006286
512,75C6B70E,1,0,1,0,0,0.000009,0,0.006286
513,7C653B0F,0,1,1,1,0,0,0,0
514,7DA6D5D8,1,0,1,0,0,0,0,0.006286
515,77555298,1,2,3,0.571429,4,0,0.000001,0.006286
516,5AD50301,4,0,4,0,0,0,0,0.037904
517,7AD4810B,3,1,4,0.666667,6,0.000003,0.000025,0.024141
518,7DD538B4,0,2,2,0.75,0,0,0.000192,0
519,7F729D1E,1,0,1,0,0,0.000006,0,0.006286
520,80F73FFB,0,1,1,0.666667,0,0,0.000001,0
521,752164CC,0,1,1,1,0,0,0,0
522,7642A860,0,3,3,0.714286,0,0,0.000098,0
523,7C5F5BF9,0,1,1,1,0,0,0.000002,0
524,804F7527,1,4,5,1,0,0.00738,0.014371,0.063491
525,7DFB2A52,0,2,2,1,0,0,0,0
526,7B736368,0,2,2,1,0,0,0,0
527,761FC760,1,0,1,0,0,0.000003,0,0.011568
528,7F172172,2,0,2,0,0,0.000007,0,0.012573
529,78115BCE,1,0,1,0,0,0.014072,0,0.006286
530,7CB679B5,0,2,2,0.555556,0,0,0.04824,0
531,7A7095A9,0,1,1,1,0,0,0,0
532,7F463162,0,1,1,0.666667,0,0,0,0
533,7BFAA845,0,3,3,0.8,0,0,0.0078,0
534,782DB1F0,1,1,2,1,1,0,0,0.006286
535,7A7259C0,0,1,1,1,0,0,0.000004,0
536,7A69966C,1,1,2,1,0,0,0,0.006286
537,80257CE6,1,0,1,0,0,0,0,0.006286
538,79C45A68,1,1,2,1,1,0,0,0.006286
539,61D140CF,0,1,1,0.666667,0,0,0,0
540,809ABB22,0,1,1,1,0,0,0,0
541,7A1C5E1B,5,0,5,0,0,0,0,0.0863
542,81758CAA,0,3,3,0.636364,0,0,0.006467,0
543,7E2694E8,0,1,1,0.32,0,0,0,0
544,7AD24F57,0,2,2,1,0,0,0.000041,0
545,780134A6,2,0,2,0,0,0,0,0.012573
546,7618557D,0,1,1,0.4,0,0,0.000001,0
547,774274ED,1,2,3,0.75,3,0,0,0.006286
548,804449F0,0,2,2,0.75,0,0,0.006398,0
549,7FB8AAC7,1,4,5,1,1.583333,0.00012,0.000222,0.006286
550,75707E47,0,2,2,0.75,0,0,0,0
551,7AE833E0,1,0,1,0,0,0.010574,0,0.053241
552,7FC302A7,1,5,6,1,2,0.000011,0.000005,0.011568
553,79C14F73,5,0,5,0,0,0,0,0.036714
554,80919766,1,0,1,0,0,0,0,0.006286
555,7AB138CD,0,2,2,0.5,0,0,0,0
556,7EF19D94,0,1,1,0.4,0,0,0,0
557,79008BAE,4,0,4,0,0,0,0,0.046271
558,7F55CF19,1,2,3,1,2,0,0.000888,0.006286
559,7A957497,0,1,1,0.6,0,0,0,0
560,7A614E25,0,3,3,1,0,0,0.002599,0
561,7BFD4AE7,1,0,1,0,0,0,0,0.006286
562,7A6EFDB4,1,1,2,0.666667,2,0,0.001167,0.006286
563,7770E3AA,2,0,2,0,0,0,0,0.012573
564,8088EF78,1,1,2,1,0,0.000022,0.000183,0.011568
565,7F18E96D,1,0,1,0,0,0,0,0.006286
566,5F75854A,1,1,2,1,0,0.000001,0.000014,0.006286
567,7742681C,0,3,3,1,0,0,0.133809,0
568,7600AB78,1,0,1,0,0,0,0,0.006286
569,7F61E9DF,0,1,1,1,0,0,0.001331,0
570,78E64353,0,1,1,1,0,0,0.047704,0
571,7C04117B,5,0,5,0,0,0.024837,0,0.109185
572,757E08A0,1,0,1,0,0,0,0,0.006286
573,76017EBD,0,1,1,1,0,0,0,0
574,7D3F095E,0,1,1,1,0,0,0,0
575,7B0EA0EB,6,0,6,0,0,0.00001,0,0.073798
576,7FF8FE5C,0,2,2,1,0,0,0,0
577,78B3E37D,0,3,3,0.8,0,0,0.000575,0
578,792944DA,0,2,2,0.571429,0,0,0.000001,0
579,78A96B50,1,4,5,1,0.333333,0.00981,0.144558,0.006286
580,58378F86,0,1,1,1,0,0,0,0
581,7C7373A9,1,0,1,0,0,0,0,0.006286
582,7EE3D7F3,1,1,2,0.666667,6,0.000142,0.006334,0.019045
583,7510A79B,1,0,1,0,0,0,0,0.006286
584,78B29352,2,1,3,1,2,0,0,0.017854
585,779449BA,3,0,3,0,0,0.000002,0,0.024141
586,7D9E2F21,2,1,3,1,1,0.000104,0.000012,0.096214
587,7A2DE665,1,0,1,0,0,0,0,0.006286
588,7658A5B9,0,2,2,1,0,0,0,0
589,78DFD3CD,1,0,1,0,0,0,0,0.006286
590,782E8FCF,0,1,1,1,0,0,0,0
591,7595563D,0,1,1,1,0,0,0,0
592,796FA59D,0,1,1,1,0,0,0,0
593,7B3508C9,0,1,1,1,0,0,0.08476,0
594,7A9D308A,0,2,2,1,0,0,0.000019,0
595,7C81E0C5,0,2,2,1,0,0,0.059927,0
596,761C5A2F,1,0,1,0,0,0,0,0.006286
597,76151614,2,2,4,0.75,4,0.000058,0.000589,0.012573
598,7AD63FCA,0,3,3,0.533333,0,0,0.049367,0
599,80EC347A,1,0,1,0,0,0,0,0.006286
600,7D72A0B3,1,0,1,0,0,0,0,0.006286
601,769233C9,0,1,1,0.6,0,0,0,0
602,8026D530,1,0,1,0,0,0.000014,0,0.006286
603,792BE139,3,2,5,0.625,33,0.017922,0.006474,0.081345
604,7BCEC334,0,1,1,1,0,0,0,0
605,76045201,1,0,1,0,0,0,0,0.006286
606,7E767C12,1,3,4,0.529412,4,0.00021,0.000044,0.006286
607,7C5AF69C,0,2,2,1,0,0,0,0
608,6EE50564,2,0,2,0,0,0.000002,0,0.067707
609,777F37D5,6,1,7,0.6,0.833333,0.027809,0.007839,0.068516
610,766C06E4,0,3,3,0.5,0,0,0.000016,0
611,81C3AA57,1,0,1,0,0,0,0,0.006286
612,7E0BF59C,0,3,3,1,0,0,0.000004,0
613,75C910DC,0,3,3,1,0,0,0,0
614,7E49C36C,0,1,1,1,0,0,0.000132,0
615,773EA55A,4,1,5,1,4,0.009559,0.000025,0.025146
616,74CF1DA2,1,0,1,0,0,0.000003,0,0.006286
617,7FCA0816,0,1,1,0.666667,0,0,0.001167,0
618,78720E8A,1,0,1,0,0,0,0,0.006286
619,6D6D341C,1,0,1,0,0,0,0,0.006286
620,7B4A441D,0,1,1,1,0,0,0,0
621,7BAEA074,0,2,2,0.75,0,0,0.091094,0
622,7B088CD1,0,3,3,1,0,0,0.003123,0
623,75AD3DDD,2,0,2,0,0,0,0,0.012573
624,78698F0C,0,2,2,0.666667,0,0,0.000569,0
625,80AB5471,1,1,2,1,1,0,0,0.006286
626,754548B7,0,1,1,0.421053,0,0,0.001445,0
627,5A2660CA,0,2,2,0.666667,0,0,0.000001,0
628,80CF8DFC,0,1,1,0.416667,0,0,0.000066,0
629,79A122BE,0,5,5,0.488372,0,0,0.096473,0
630,794AC5D6,0,3,3,0.714286,0,0,0.003466,0
631,79ABFBE4,5,0,5,0,0,0.016243,0,0.041995
632,80E6D637,0,1,1,1,0,0,0,0
633,782378F0,0,1,1,1,0,0,0,0
634,7F64B931,1,0,1,0,0,0,0,0.011568
635,7E08F1EE,1,2,3,1,0,0.0001,0.000988,0.011568
636,764D1B61,0,6,6,0.527778,0,0,0.001196,0
637,7CABB544,0,2,2,1,0,0,0,0
638,773B9691,0,3,3,1,0,0,0.001372,0
639,7E72D3CC,2,1,3,1,1,0.000003,0.00003,0.012573
640,7DBBA4BA,10,0,10,0,0,0.013274,0,0.105263
641,5D722D84,0,1,1,1,0,0,0,0
642,816B8095,1,0,1,0,0,0,0,0.006286
643,6B85C55A,0,1,1,1,0,0,0,0
644,7679D2AE,1,2,3,1,7,0.00738,0.087839,0.063491
645,7EE4A06B,0,2,2,0.75,0,0,0.006398,0
646,8259EF40,1,0,1,0,0,0,0,0.011568
647,7D5B4BB3,1,0,1,0,0,0.000058,0,0.006286
648,75D2A4BD,1,4,5,0.615385,4,0,0,0.006286
649,7FC41C91,2,3,5,1,2.5,0.013835,0.133837,0.012573
650,7A98C297,0,1,1,1,0,0,0.08476,0
651,799D0072,0,1,1,1,0,0,0,0
652,77090234,0,1,1,1,0,0,0,0
653,7FF3BD92,0,1,1,1,0,0,0,0
654,7AA19F1F,1,2,3,1,2,0.008585,0.001819,0.006286
655,45F724D6,1,0,1,0,0,0,0,0.006286
656,7D2B5DB5,0,2,2,1,0,0,0,0
657,7A002209,0,1,1,1,0,0,0,0
658,7FBC58AE,1,0,1,0,0,0.000642,0,0.006286
659,7D274E51,1,0,1,0,0,0,0,0.006286
660,76661B2F,0,1,1,1,0,0,0,0
661,809A2EAB,0,2,2,1,0,0,0.048194,0
662,7BB52E57,0,1,1,1,0,0,0.08476,0
663,7947FD0A,1,0,1,0,0,0,0,0.006286
664,80A17691,1,1,2,1,1,0,0.08476,0.006286
665,7D7F26E6,2,1,3,0.666667,0.5,0.000106,0.00001,0.078872
666,806CFF40,0,1,1,0.277778,0,0,0,0
667,5F6A3915,1,0,1,0,0,0,0,0.006286
668,781B8E8A,11,1,12,1,11,0.033868,0.047704,0.233293
669,7B1AA3CE,0,3,3,0.8,0,0,0.000029,0
670,7E998AAE,1,1,2,1,8.5,0,0,0.038991
671,7ED9DF80,2,0,2,0,0,0,0,0.028417
672,7B8494F4,2,3,5,1,18,0.000129,0.012534,0.043972
673,78E627DD,10,1,11,1,12,0.001215,0.000044,0.133865
674,8114B38D,0,1,1,0.666667,0,0,0.006334,0
675,7E32AB4C,0,2,2,1,0,0,0.087178,0
676,7738B11A,1,3,4,1,2,0.000248,0.000034,0.006286
677,78DBEEB2,0,1,1,1,0,0,0.000004,0
678,800A3493,2,2,4,1,2,0,0,0.012573
679,7B87A2E4,0,2,2,0.571429,0,0,0,0
680,79E037AD,0,3,3,0.583333,0,0,0,0
681,8118E97E,0,2,2,0.75,0,0,0,0
682,803DC8CD,0,1,1,1,0,0,0,0
683,7AC69432,0,1,1,1,0,0,0,0
684,7E5CA07D,1,1,2,1,0,0,0,0.006286
685,7BFE4898,0,2,2,1,0,0,0.000004,0
686,7AA39D81,0,3,3,0.5,0,0,0,0
687,75BECA36,0,2,2,1,0,0,0.000085,0
688,7D75A524,6,1,7,1,0.5,0.000235,0.000183,0.108283
689,7DD93C5B,0,3,3,0.6,0,0,0,0
690,6B5301A2,0,3,3,0.625,0,0,0.000644,0
691,781C9059,10,13,23,0.703704,163.333333,0.048017,0.073598,0.073427
692,7E247886,2,2,4,0.75,0,0.000011,0.000002,0.025331
693,779B8D26,0,1,1,1,0,0,0.08476,0
694,7FBD9721,0,1,1,0.6,0,0,0,0
695,79466BAF,1,0,1,0,0,0,0,0.006286
696,7971787D,3,3,6,0.555556,3.5,0.000001,0.000022,0.024141
697,80BFF818,1,4,5,0.7,0.5,0.001482,0.010282,0.011568
698,7AA430A8,2,3,5,0.8,2,0.011989,0.014024,0.017854
699,7B2F142E,0,2,2,1,0,0,0,0
700,79D5B605,0,2,2,1,0,0,0.001358,0
701,787B131D,0,1,1,1,0,0,0,0
702,8098C8FD,5,0,5,0,0,0.000012,0,0.09187
703,7DE355E1,1,0,1,0,0,0,0,0.006286
704,8046BB2D,1,2,3,0.346154,9,0,0,0.006286
705,802828E7,0,8,8,0.515152,0,0,0.000054,0
706,7FEEB1E8,0,1,1,1,0,0,0.002008,0
707,7AFFACED,1,1,2,1,1,0,0.000001,0.006286
708,7F4D6AED,0,2,2,1,0,0,0.000022,0
709,8128B217,0,1,1,1,0,0,0,0
710,7F6164F3,2,1,3,1,0,0,0,0.012573
711,7BD213AB,0,1,1,1,0,0,0,0
712,7F419F38,0,1,1,1,0,0,0,0
713,81155599,1,0,1,0,0,0.000002,0,0.006286
714,76179EFF,0,1,1,1,0,0,0,0
715,7B94EF95,1,0,1,0,0,0,0,0.011568
716,7C17BB5E,1,0,1,0,0,0.000244,0,0.006286
717,7BCBA8DF,1,1,2,1,1,0,0.000028,0.006286
718,7D135050,1,0,1,0,0,0,0,0.006286
719,7A464788,0,1,1,1,0,0,0.08476,0
720,7B05A3F8,0,1,1,1,0,0,0.000017,0
721,7C1603E0,0,6,6,0.565217,0,0,0.000001,0
722,7E5B004A,1,0,1,0,0,0,0,0.006286
723,78C114F8,0,1,1,1,0,0,0,0
724,7AB6B34C,0,1,1,1,0,0,0,0
725,79E3D3EA,0,2,2,0.4375,0,0,0.000001,0
726,79B8FEAF,3,0,3,0,0,0,0,0.024141
727,79CE2FD9,0,1,1,1,0,0,0,0
728,786275E3,4,0,4,0,0,0.000026,0,0.032623
729,7B182881,8,2,10,0.666667,16.5,0.000002,0.000012,0.068331
730,7A845159,1,1,2,1,0.5,0,0,0.006286
731,7A786E5F,1,1,2,1,0,0,0,0.006286
732,8028AB8B,0,2,2,0.75,0,0,0.000014,0
733,7C63D455,0,1,1,1,0,0,0,0
734,770F4960,0,1,1,1,0,0,0,0
735,772F3CB1,19,0,19,0,0,0.001828,0,0.368873
736,7F4E7FA4,0,2,2,0.354839,0,0,0,0
737,80710D39,2,0,2,0,0,0,0,0.012573
738,7FF3829D,0,1,1,1,0,0,0.000066,0
739,7FCB9B29,0,1,1,1,0,0,0,0
740,80257039,0,2,2,0.75,0,0,0.000975,0
741,7BD96528,0,2,2,0.75,0,0,0.000001,0
742,764CC2BF,2,3,5,1,3,0.00002,0.000004,0.012573
743,770EB885,3,3,6,0.714286,19,0.000002,0.000015,0.034704
744,81158F4F,0,2,2,0.555556,0,0,0,0
745,75F9C7CA,0,1,1,0.571429,0,0,0,0
746,76D1ABEA,1,0,1,0,0,0,0,0.006286
747,7F492136,0,3,3,0.636364,0,0,0.001058,0
748,7781A4C9,0,1,1,0.6,0,0,0,0
749,80E79645,0,2,2,1,0,0,0.085639,0
750,7FA0CE6E,1,3,4,0.8,2,0.000656,0.000117,0.006286
751,77B4AFA3,1,0,1,0,0,0.000003,0,0.006286
752,75EC18C4,0,1,1,1,0,0,0,0
753,7F9C43E6,0,1,1,0.6,0,0,0.000001,0
754,0BEED53D,0,2,2,0.75,0,0,0.000029,0
755,5AE3B951,0,1,1,0.380952,0,0,0,0
756,7ADD7C22,1,0,1,0,0,0,0,0.006286
757,7E80F59D,1,0,1,0,0,0,0,0.011568
758,794193CF,0,2,2,1,0,0,0,0
759,6EDADF2F,1,0,1,0,0,0,0,0.006286
760,803CB810,0,1,1,1,0,0,0.000004,0
761,77CF4FF9,0,1,1,0.666667,0,0,0,0
762,7623C9AD,0,2,2,1,0,0,0.000014,0
763,80261415,0,1,1,1,0,0,0.000076,0
764,76FDED8D,1,0,1,0,0,0,0,0.022131
765,7B14530B,1,3,4,1,0.5,0,0,0.019045
766,7EE0066B,1,3,4,0.533333,8,0.000005,0,0.006286
767,7F85252B,1,0,1,0,0,0.000106,0,0.006286
768,77B8DAD0,1,0,1,0,0,0,0,0.006286
769,75CD7245,0,2,2,0.666667,0,0,0.085641,0
770,75C8A725,1,0,1,0,0,0.000016,0,0.011568
771,757F0B78,1,0,1,0,0,0,0,0.011568
772,024B5742,0,3,3,0.714286,0,0,0.000001,0
773,7869EC64,0,1,1,1,0,0,0,0
774,7F84FA65,0,3,3,1,0,0,0.000017,0
775,7B1998B6,1,0,1,0,0,0.000782,0,0.006286
776,7C112C99,5,1,6,1,5.5,0.011636,0.08476,0.041995
777,760C4416,0,1,1,0.6,0,0,0,0
778,7C80A8FA,1,0,1,0,0,0,0,0.006286
779,5A22BD72,1,0,1,0,0,0,0,0.006286
780,80B64094,0,2,2,0.666667,0,0,0.007919,0
781,055BF9E5,0,1,1,0.666667,0,0,0.006334,0
782,7F18DF9D,1,0,1,0,0,0.000005,0,0.006286
783,7F626867,0,3,3,1,0,0,0.048878,0
784,71947405,1,0,1,0,0,0,0,0.006286
785,81655BF1,1,6,7,1,2.5,0.015616,0.155282,0.006286
786,7E51FBD5,3,0,3,0,0,0.008765,0,0.024141
787,772271FA,0,1,1,0.571429,0,0,0.006467,0
788,7932791C,0,3,3,1,0,0,0,0
789,7AD990EF,2,0,2,0,0,0,0,0.012573
790,8124F81B,0,2,2,0.666667,0,0,0.001668,0
791,75569403,2,0,2,0,0,0,0,0.012573
792,7A004754,3,1,4,1,7,0,0,0.044376
793,7F844562,4,0,4,0,0,0.000173,0,0.037904
794,7FD65373,10,2,12,1,29,0.000007,0.000004,0.152773
795,7C9864DB,1,0,1,0,0,0,0,0.006286
796,77CF7516,1,1,2,1,1,0.000012,0.001388,0.006286
797,7794E55C,1,0,1,0,0,0,0,0.006286
798,803D461C,0,2,2,0.625,0,0,0,0
799,7E8A4A6F,1,1,2,1,1,0,0.000014,0.006286
800,78836AB2,1,0,1,0,0,0,0,0.006286
801,7CA74CE9,1,0,1,0,0,0.000488,0,0.006286
802,7918C8E2,1,0,1,0,0,0,0,0.006286
803,78997286,0,1,1,1,0,0,0.000001,0
804,7652307F,2,0,2,0,0,0,0,0.012573
805,7C990C26,0,1,1,1,0,0,0,0
806,79DA61D9,4,2,6,1,7,0,0.000018,0.030427
807,7DED82BE,1,0,1,0,0,0,0,0.006286
808,801A291B,0,5,5,0.611111,0,0,0,0
809,78C9FC4F,0,1,1,0.666667,0,0,0,0
810,7AD78671,2,0,2,0,0,0.00002,0,0.017854
811,7F0738FC,2,1,3,1,0,0.000003,0.000012,0.017854
812,7B982CA0,1,1,2,1,1,0,0,0.006286
813,7DD8CCDE,0,4,4,0.833333,0,0,0.002497,0
814,759EAFBE,1,0,1,0,0,0,0,0.006286
815,77F6DD96,0,3,3,0.464286,0,0,0.000082,0
816,7D89F3DD,0,1,1,1,0,0,0,0
817,76A06E8C,2,3,5,0.625,9,0.000002,0.001417,0.017854
818,7BA293B7,1,3,4,1,0.583333,0.00012,0.00022,0.006286
819,7859EA80,0,2,2,0.666667,0,0,0.085621,0
820,7F8F53F9,3,2,5,0.666667,1,0.019718,0.005604,0.104502
821,7F71C952,1,1,2,1,7,0.00016,0.047704,0.034889
822,604AF804,1,0,1,0,0,0,0,0.006286
823,7C06118E,0,1,1,1,0,0,0.000028,0
824,7E6CB4EA,3,0,3,0,0,0.000655,0,0.024141
825,7D2FF258,0,2,2,1,0,0,0.000356,0
826,815ECC35,0,1,1,1,0,0,0,0
827,79BB0CFC,0,3,3,1,0,0,0.048683,0
828,80C7309D,1,2,3,1,2,0,0.132464,0.006286
829,7638B67F,0,1,1,1,0,0,0.047704,0
830,814C4177,1,0,1,0,0,0,0,0.006286
831,7AAE4153,2,1,3,1,0,0.000004,0.000014,0.017854
832,7F6F311C,0,3,3,0.636364,0,0,0.012705,0
833,8148F7CE,2,2,4,1,2,0,0.000005,0.012573
834,77F6E315,0,7,7,0.818182,0,0,0.013286,0
835,798A360F,2,1,3,1,1,0.000024,0.000183,0.012573
836,7D9E2A78,1,0,1,0,0,0,0,0.006286
837,7F07F362,2,0,2,0,0,0,0,0.017854
838,790AD784,0,1,1,0.6,0,0,0,0
839,8082E5C1,2,1,3,1,2,0.004882,0.001651,0.012573
840,76DB5AC3,2,1,3,1,2,0,0,0.017854
841,7BA74C29,2,1,3,0.5,6,0.000002,0,0.012573
842,7C7385FA,0,4,4,1,0,0,0,0
843,78869908,0,2,2,1,0,0,0,0
844,7DE0782B,1,2,3,0.75,2,0,0,0.006286
845,7B5A2ABB,2,4,6,0.833333,8,0.000456,0.008447,0.012573
846,7915ABFA,1,1,2,1,0,0,0,0.006286
847,7CA892A9,0,1,1,1,0,0,0,0
848,77631B77,3,0,3,0,0,0.009197,0,0.024141
849,7C39DDBE,0,4,4,0.666667,0,0,0,0
850,7A111B71,0,1,1,1,0,0,0,0
851,7747E451,0,1,1,0.666667,0,0,0.000122,0
852,7DCE018B,29,0,29,0,0,0.000043,0,0.405296
853,75198291,0,1,1,1,0,0,0,0
854,7F8D8BD5,2,4,6,0.833333,8,0.005862,0.099896,0.012573
855,7EB1FAFE,1,1,2,0.5,0,0,0.000001,0.006286
856,7B78D0EB,0,1,1,0.666667,0,0,0.001167,0
857,02E6F8AF,0,1,1,0.666667,0,0,0.000001,0
858,7CFF34A2,0,1,1,1,0,0,0.000002,0
859,7E592F49,2,0,2,0,0,0,0,0.012573
860,7D577E12,0,5,5,0.727273,0,0,0.093976,0
861,77FD6CDA,0,1,1,1,0,0,0.08476,0
862,7B405154,1,0,1,0,0,0.000002,0,0.006286
863,2EFA8D54,0,1,1,1,0,0,0.001629,0
864,75FEB0B8,1,3,4,1,3,0,0.000002,0.006286
865,7F914FBD,0,1,1,1,0,0,0,0
866,7DA3BC91,0,3,3,0.483871,0,0,0.000142,0
867,7AEDD007,2,0,2,0,0,0,0,0.012573
868,7F2D8ADD,0,1,1,0.6,0,0,0.00002,0
869,72710993,1,0,1,0,0,0,0,0.006286
870,7EFA941A,15,0,15,0,0,0.000299,0,0.192573
871,79DC023A,2,1,3,1,2,0,0,0.012573
872,7E140A5A,1,0,1,0,0,0,0,0.006286
873,8081997D,0,2,2,0.538462,0,0,0.000133,0
874,84BFE557,2,0,2,0,0,0.000005,0,0.012573
875,78C33C59,0,4,4,0.833333,0,0,0.097837,0
876,778959AE,17,2,19,1,24.666667,0.078178,0.0511,0.192099
877,76C4E8E3,1,0,1,0,0,0,0,0.006286
878,78E090CD,0,1,1,0.6,0,0,0,0
879,7840779D,1,0,1,0,0,0,0,0.006286
880,8038E121,0,1,1,1,0,0,0,0
881,7DEED417,0,5,5,0.555556,0,0,0.142251,0
882,7BFE3551,0,3,3,0.8,0,0,0,0
883,7829A414,0,2,2,1,0,0,0.000002,0
884,220EDA42,1,2,3,0.444444,1,0.00552,0.089574,0.006286
885,809B3823,0,3,3,1,0,0,0,0
886,755884D5,58,0,58,0,0,0.475745,0,0.998457
887,7C9325DB,0,1,1,0.666667,0,0,0,0
888,751705C0,1,0,1,0,0,0.000002,0,0.006286
889,7BD0404A,1,0,1,0,0,0,0,0.011568
890,7EF9CF6D,2,0,2,0,0,0,0,0.012573
891,814D0E28,0,1,1,1,0,0,0,0
892,7917C0CE,1,0,1,0,0,0.000642,0,0.006286
893,7BAF97E7,0,1,1,1,0,0,0,0
894,785A4F8C,0,5,5,0.5,0,0,0.002093,0
895,79B1098F,0,1,1,1,0,0,0.000001,0
896,7F9E370D,1,4,5,1,0,0.001332,0.002525,0.006286
897,7D60B88F,0,2,2,0.571429,0,0,0.001668,0
898,76D604E3,1,0,1,0,0,0,0,0.006286
899,8030B293,0,1,1,1,0,0,0.001331,0
900,75C4FE7F,1,0,1,0,0,0,0,0.011568
901,77AB12F3,5,0,5,0,0,0.000109,0,0.079692
902,7F8267B3,3,3,6,0.583333,15,0.000002,0.000005,0.018859
903,7D10374F,3,0,3,0,0,0.000012,0,0.047173
904,786FAD7D,7,0,7,0,0,0.01384,0,0.080084
905,7CB3CA70,0,2,2,1,0,0,0.000002,0
906,162F8493,0,5,5,0.434783,0,0,0.000156,0
907,770468A5,0,3,3,0.615385,0,0,0.01626,0
908,7D31C841,1,0,1,0,0,0,0,0.006286
909,7ECE7129,1,3,4,0.714286,8,0,0.000001,0.011568
910,7845EB88,18,0,18,0,0,0.016464,0,0.186275
911,75BDDE3B,6,0,6,0,0,0.000436,0,0.172945
912,00E058A6,0,3,3,0.714286,0,0,0.000142,0
913,7FF6EC3B,5,0,5,0,0,0.000114,0,0.036714
914,775FA92B,1,0,1,0,0,0,0,0.006286
915,7AEE087F,1,0,1,0,0,0.000348,0,0.006286
916,7DCE525A,1,0,1,0,0,0,0,0.006286
917,7586A4B1,2,2,4,1,7.5,0.000052,0.008342,0.028417
918,759426D3,2,0,2,0,0,0.000475,0,0.044065
919,7F2CDB19,1,1,2,0.666667,0,0.000245,0.002418,0.006286
920,7F7BF93A,0,1,1,1,0,0,0.000004,0
921,3DB84053,0,1,1,1,0,0,0.08476,0
922,7DDDA5DE,1,1,2,1,1,0,0,0.006286
923,80CCAEEE,0,1,1,1,0,0,0.001629,0
924,806C7D55,0,3,3,1,0,0,0.001685,0
925,76103F45,1,1,2,1,1,0,0,0.006286
926,7AD3064F,1,0,1,0,0,0,0,0.006286
927,751F0773,0,2,2,0.75,0,0,0.000266,0
928,7F5A5E75,1,3,4,0.8,0.333333,0.010507,0.140303,0.006286
929,79126E8F,1,2,3,0.47619,4.5,0,0.000004,0.006286
930,810659AB,0,1,1,0.5,0,0,0,0
931,80DE24E6,0,4,4,0.636364,0,0,0.135211,0
932,7D8C6D8C,1,0,1,0,0,0,0,0.006286
933,812C993A,2,2,4,0.75,6,0.000214,0.085725,0.017854
934,7D3B93CD,0,1,1,1,0,0,0,0
935,7BEE9ADC,2,0,2,0,0,0,0,0.012573
936,7E6E4E7C,0,3,3,1,0,0,0.000002,0
937,7649B187,0,4,4,0.7,0,0,0.000013,0
938,75EA990A,1,0,1,0,0,0.000098,0,0.006286
939,771EDAE4,2,0,2,0,0,0,0,0.012573
940,7FA6260C,2,1,3,0.666667,1,0.000662,0.006334,0.012573
941,7A0E6CD2,0,1,1,1,0,0,0.001651,0
942,7CC9FACE,0,1,1,1,0,0,0,0
943,7A473D89,0,1,1,0.5,0,0,0.000001,0
944,63934380,1,7,8,0.888889,7.5,0,0.000028,0.006286
945,5F18B1BE,0,2,2,1,0,0,0.008342,0
946,7D33BB0F,0,1,1,1,0,0,0.000002,0
947,7AE22314,1,2,3,1,0.5,0,0,0.006286
948,7C8AC987,1,0,1,0,0,0.000794,0,0.006286
949,7DD580D6,0,2,2,1,0,0,0.000002,0
950,76ADDB56,0,1,1,1,0,0,0,0
951,7A62872B,0,1,1,1,0,0,0,0
952,7C9EE2B1,0,2,2,1,0,0,0.085727,0
953,76D7E7F1,1,0,1,0,0,0,0,0.006286
954,8055A8B1,0,1,1,1,0,0,0.001629,0
955,7B905D28,0,2,2,0.47619,0,0,0.000004,0
956,7DA9D824,0,1,1,1,0,0,0.000014,0
957,786331DD,0,1,1,1,0,0,0.001651,0
958,7B434F7B,7,0,7,0,0,0.030709,0,0.220245
959,7C3AC4EB,0,3,3,0.8,0,0,0,0
960,7FB563E4,3,0,3,0,0,0.000002,0,0.04129
961,7B5C5606,1,1,2,1,0,0.000115,0.000183,0.037686
962,7D445EE7,0,2,2,1,0,0,0.001174,0
963,7B2AA4DD,1,0,1,0,0,0.004832,0,0.006286
964,7822CD27,8,0,8,0,0,0.001897,0,0.091652
965,7A366D0E,4,1,5,0.5,9,0.00001,0,0.030427
966,7A310D4F,1,0,1,0,0,0,0,0.006286
967,8168E7F5,0,1,1,1,0,0,0,0
968,802C9DFB,0,1,1,0.666667,0,0,0.000023,0
969,8162987C,2,1,3,1,0,0,0,0.017854
970,7BBE7213,3,0,3,0,0,0,0,0.024141
971,7BA8E649,0,1,1,0.666667,0,0,0.000001,0
972,7A43D23B,1,1,2,1,2,0,0.000003,0.011568
973,76F569BB,0,1,1,1,0,0,0.08476,0
974,5BD0B0D5,0,2,2,0.47619,0,0,0.000004,0
975,773C4127,0,1,1,1,0,0,0.08476,0
976,7B4EF606,0,5,5,0.56,0,0,0.000001,0
977,77F2D934,0,2,2,1,0,0,0.085621,0
978,7C899F5F,1,1,2,1,1,0,0.000002,0.006286
979,80C28EA9,1,2,3,1,2,0,0,0.006286
980,79638FA6,0,1,1,1,0,0,0,0
981,7E444521,1,2,3,0.666667,2,0.001742,0.018691,0.006286
982,7EF979D3,2,2,4,0.6,36,0,0.000123,0.030612
983,5BB4F421,1,0,1,0,0,0,0,0.011568
984,7583AAE6,3,1,4,1,2,0.000713,0.000164,0.036899
985,79290555,0,1,1,0.666667,0,0,0.007389,0
986,7DC9793F,0,3,3,0.666667,0,0,0.000001,0
987,7D06C752,1,3,4,1,3,0,0.000047,0.006286
988,776AA1E6,0,1,1,1,0,0,0,0
989,80B0F273,0,1,1,1,0,0,0.000044,0
990,80295718,0,3,3,1,0,0,0,0
991,7664BD66,0,2,2,1,0,0,0.000033,0
992,77D0FB94,0,2,2,1,0,0,0.005148,0
993,80D72754,0,1,1,0.5,0,0,0,0
994,7DCF19EA,0,1,1,1,0,0,0,0
995,7D224321,0,2,2,0.434783,0,0,0.052519,0
996,7CE4E89C,2,2,4,0.666667,5.5,0.005341,0.018691,0.012573
997,7CBDC14B,1,1,2,1,0,0.000169,0.001651,0.006286
998,773F1306,0,2,2,0.75,0,0,0.000589,0
999,7A9F2747,0,4,4,0.636364,0,0,0.017368,0
1000,78B616AB,3,1,4,1,5,0.000002,0,0.036899
1001,786383BC,17,1,18,1,19,0.024117,0.08476,0.186818
1002,807A21A4,5,0,5,0,0,0.000175,0,0.078144
1003,7837F158,0,1,1,1,0,0,0,0
1004,7AE95175,0,2,2,1,0,0,0.004137,0
1005,7AF0BB22,0,1,1,1,0,0,0.000026,0
1006,7EC21E0B,0,1,1,1,0,0,0,0
1007,80364AD2,1,1,2,1,1,0,0,0.006286
1008,7CD55D67,3,1,4,1,3,0.001603,0.001388,0.024141
1009,77D4E70E,3,0,3,0,0,0.000003,0,0.039985
1010,7BE9966F,1,0,1,0,0,0,0,0.006286
1011,7B7A635F,0,1,1,0.5,0,0,0,0
1012,7EEF539F,0,2,2,1,0,0,0.000888,0
1013,797AB18D,0,1,1,1,0,0,0,0
1014,7534C2DF,1,3,4,0.47619,2.333333,0.009674,0.011159,0.006286
1015,7B291343,0,2,2,1,0,0,0,0
1016,7B7A5138,7,1,8,1,1.833333,0.073687,0.047704,0.088452
1017,7B8406B1,1,2,3,1,1,0.000002,0,0.006286
1018,7976FBBB,0,2,2,1,0,0,0,0
1019,76B13E93,0,2,2,1,0,0,0,0
1020,79D2FC2D,1,3,4,0.666667,3,0,0,0.006286
1021,7AD6CA6D,0,2,2,0.75,0,0,0.002974,0
1022,76A04BD1,0,1,1,1,0,0,0.047704,0
1023,7B14E5D3,1,1,2,1,1,0,0.08476,0.006286
1024,76838897,0,2,2,0.666667,0,0,0,0
1025,7CE086A7,1,0,1,0,0,0.000169,0,0.006286
1026,7DBB2A65,1,0,1,0,0,0.000115,0,0.037686
1027,7DD1B8E4,0,1,1,0.666667,0,0,0.002418,0
1028,7BD2EAB3,0,2,2,1,0,0,0,0
1029,5BA09B8A,1,0,1,0,0,0,0,0.006286
1030,780745D4,0,1,1,1,0,0,0,0
1031,82FF526B,0,2,2,0.4375,0,0,0.004865,0
1032,7BCC10ED,0,4,4,0.52,0,0,0.000004,0
1033,7BC402AC,4,0,4,0,0,0,0,0.030427
1034,7183B6F3,3,0,3,0,0,0,0,0.018859
1035,8119CF09,2,0,2,0,0,0.000014,0,0.012573
1036,779D8DE4,0,8,8,0.75,0,0,0.155739,0
1037,766EBE18,0,1,1,0.444444,0,0,0,0
1038,790017EF,0,1,1,1,0,0,0.001574,0
1039,7F6DA698,1,0,1,0,0,0.000005,0,0.006286
1040,804433CC,1,1,2,0.666667,0,0.000007,0.000069,0.006286
1041,7CEE09AC,1,3,4,1,3,0,0,0.006286
1042,7A96575F,0,2,2,0.75,0,0,0.002443,0
1043,78FBAF70,2,0,2,0,0,0,0,0.012573
1044,7F90C964,1,2,3,1,2,0,0.000197,0.006286
1045,7BE5EAEC,1,0,1,0,0,0,0,0.006286
1046,7F70716E,5,7,12,0.733333,67.25,0.000183,0.001143,0.04419
1047,7A26A010,1,3,4,0.714286,1,0.000001,0.000013,0.006286
1048,80A33F82,0,1,1,1,0,0,0,0
1049,7931ED89,1,0,1,0,0,0,0,0.006286
1050,5E0CB839,2,0,2,0,0,0,0,0.012573
1051,7B86FE6D,0,8,8,0.586207,0,0,0.104788,0
1052,7AB334F8,3,0,3,0,0,0.000256,0,0.018859
1053,7DDB0F75,3,1,4,1,2,0,0,0.018859
1054,76168B85,0,3,3,0.8,0,0,0.003932,0
1055,66C0FE78,4,0,4,0,0,0,0,0.035709
1056,80CF84F0,3,1,4,0.47619,0,0.000001,0,0.024141
1057,79AF616B,0,1,1,1,0,0,0.08476,0
1058,7D3F6DDC,3,0,3,0,0,0.000001,0,0.035139
1059,7F492560,1,0,1,0,0,0,0,0.006286
1060,7742E782,1,0,1,0,0,0,0,0.006286
1061,8113BCCD,5,2,7,0.75,7.5,0.000003,0.000001,0.036714
1062,800019D5,0,1,1,1,0,0,0.08476,0
1063,77474425,1,0,1,0,0,0,0,0.006286
1064,764CFE47,2,0,2,0,0,0,0,0.012573
1065,791CB284,0,1,1,0.425532,0,0,0.004815,0
1066,79BB039F,0,1,1,0.666667,0,0,0,0
1067,55AD3B68,0,2,2,1,0,0,0.000085,0
1068,7FFDC30F,5,0,5,0,0,0.000182,0,0.062832
1069,7CC5D876,1,1,2,1,0,0.008585,0.08476,0.006286
1070,5A898452,2,0,2,0,0,0,0,0.012573
1071,7B5D9AA9,0,2,2,1,0,0,0.000202,0
1072,7AB5539E,0,1,1,1,0,0,0.002008,0
1073,7CB7F16E,0,2,2,0.666667,0,0,0,0
1074,79927822,1,1,2,1,0,0,0,0.006286
1075,7AC6FA41,0,2,2,1,0,0,0,0
1076,7777AF72,0,1,1,1,0,0,0,0
1077,7D67065A,0,1,1,1,0,0,0,0
1078,7D2240D5,1,1,2,0.5,0,0.015616,0.001582,0.006286
1079,758FEEBF,0,1,1,1,0,0,0,0
1080,78815E37,1,6,7,0.8,5.5,0.00738,0.018318,0.063491
1081,7702813E,3,1,4,0.666667,2,0.000028,0.000134,0.018859
1082,75529BAD,1,0,1,0,0,0,0,0.006286
1083,7AB2D9AE,0,1,1,1,0,0,0,0
1084,7622159D,0,1,1,1,0,0,0,0
1085,815BFF4C,0,1,1,1,0,0,0,0
1086,6CBD491E,1,0,1,0,0,0,0,0.006286
1087,7A2C0ECD,1,0,1,0,0,0,0,0.006286
1088,83E77A38,0,1,1,1,0,0,0,0
1089,8069DB01,1,1,2,1,1,0,0,0.006286
1090,81267C44,1,0,1,0,0,0.004882,0,0.006286
1091,800649A3,2,2,4,1,3,0.008655,0.132464,0.06945
1092,7EC6EA4A,0,1,1,0.5,0,0,0.000001,0
1093,7D333ADE,0,2,2,0.75,0,0,0.005404,0
1094,7CD877F7,1,1,2,0.571429,8,0,0.006467,0.011568
1095,7D7B8DFC,1,0,1,0,0,0,0,0.006286
1096,7BE1580D,0,1,1,1,0,0,0,0
1097,78781A7D,0,6,6,0.875,0,0,0.000064,0
1098,78C75B64,1,0,1,0,0,0,0,0.006286
1099,785BEF1C,0,1,1,1,0,0,0.000025,0
1100,760C0B34,3,1,4,1,3,0,0,0.018859
1101,80C27F6B,0,1,1,1,0,0,0,0
1102,7DF97E6F,2,2,4,0.571429,2,0,0,0.012573
1103,7A6AEC98,2,1,3,1,0,0,0,0.012573
1104,816CDA9D,2,4,6,0.833333,7,0.000662,0.151021,0.012573
1105,7B3E675E,1,1,2,1,1,0,0.08476,0.006286
1106,77A210FF,1,0,1,0,0,0,0,0.006286
1107,7F884D24,0,2,2,0.666667,0,0,0.000123,0
1108,5CAEAD77,0,1,1,1,0,0,0.000001,0
1109,786C687F,0,2,2,1,0,0,0.000033,0
1110,771DB9C2,2,1,3,1,1,0,0,0.012573
1111,7554D54F,2,0,2,0,0,0,0,0.012573
1112,7872948D,1,0,1,0,0,0,0,0.006286
1113,7DD1F9A4,0,2,2,0.75,0,0,0.000093,0
1114,7663E3DE,1,1,2,1,1,0,0.000179,0.006286
1115,76CC299C,13,0,13,0,0,0.000001,0,0.232084
1116,7EFB3668,0,2,2,1,0,0,0.000066,0
1117,80976330,1,0,1,0,0,0.000089,0,0.011568
1118,7D7DA9B8,0,1,1,1,0,0,0,0
1119,7AA3810C,3,2,5,1,0,0.000013,0.000033,0.024141
1120,75A3B21D,1,0,1,0,0,0,0,0.029607
1121,7E766C86,0,2,2,0.75,0,0,0.000096,0
1122,800AEA1E,0,3,3,1,0,0,0,0
1123,7ABD250E,1,0,1,0,0,0,0,0.006286
1124,7A6D78F7,1,0,1,0,0,0,0,0.011568
1125,7F92E741,1,0,1,0,0,0,0,0.006286
1126,7D196689,0,1,1,0.666667,0,0,0.002418,0
1127,7CBFF3B0,1,0,1,0,0,0,0,0.006286
1128,79AE7C15,0,1,1,1,0,0,0,0
1129,835C6FFF,0,1,1,1,0,0,0,0
1130,760E3F69,1,1,2,1,0,0.00025,0.000028,0.006286
1131,786B701A,1,1,2,1,0,0.000036,0.000183,0.022131
1132,7C2EB559,0,2,2,0.555556,0,0,0.000001,0
1133,804930CF,0,1,1,1,0,0,0,0
1134,77451608,3,3,6,0.8,28,0.019221,0.004642,0.065337
1135,785B4B63,3,0,3,0,0,0.000011,0,0.029422
1136,7A6C21B7,0,2,2,0.75,0,0,0,0
1137,7F5E0D63,0,3,3,0.8,0,0,0.0009,0
1138,7FE9D925,1,2,3,1,2,0,0.000024,0.006286
1139,795AF71E,0,2,2,1,0,0,0,0
1140,77EF8ED4,0,1,1,0.5,0,0,0.000006,0
1141,7F63548B,5,0,5,0,0,0.000001,0,0.036714
1142,7BF9B329,4,1,5,0.666667,8,0,0,0.035709
1143,7D9E5D3A,0,1,1,1,0,0,0,0
1144,7899B6B6,4,1,5,1,0,0.001657,0.00019,0.035709
1145,7EB6E8D3,0,1,1,1,0,0,0,0
1146,7B51E8A5,0,2,2,1,0,0,0,0
1147,84A1FC82,0,3,3,0.6,0,0,0.097968,0
1148,79246C10,0,2,2,1,0,0,0.000134,0
1149,78B8D6A7,1,0,1,0,0,0,0,0.011568
1150,7AB7EE55,0,1,1,1,0,0,0,0
1151,7577E97F,0,1,1,1,0,0,0,0
1152,77CDEF16,1,3,4,0.583333,7,0,0.000001,0.006286
1153,75C78FFC,0,1,1,1,0,0,0,0
1154,773006A4,1,0,1,0,0,0,0,0.011568
1155,77981352,1,2,3,1,1,0.000019,0.000356,0.006286
1156,78646E8C,4,0,4,0,0,0.000002,0,0.025146
1157,76E9FDC8,0,1,1,1,0,0,0,0
1158,77D1C145,0,2,2,0.75,0,0,0,0
1159,80A8C852,1,3,4,1,6,0,0.000002,0.013763
1160,781DE76E,0,2,2,1,0,0,0,0
1161,7E5A88C3,1,1,2,1,0.5,0,0.000014,0.006286
1162,78BE3144,0,3,3,1,0,0,0,0
1163,7B472A4B,1,0,1,0,0,0,0,0.006286
1164,8030EE0C,0,3,3,0.666667,0,0,0.002473,0
1165,5DF7E321,0,1,1,1,0,0,0.00003,0
1166,78F99F5F,1,0,1,0,0,0,0,0.006286
1167,7BCA8004,0,1,1,1,0,0,0.08476,0
1168,7C3E5264,0,2,2,0.75,0,0,0,0
1169,7AE4D54E,0,1,1,1,0,0,0,0
1170,78A26CF3,1,1,2,0.35,14,0.000097,0.000012,0.006286
1171,7DDB421B,1,6,7,0.875,7,0,0.000108,0.006286
1172,77A8FA4A,0,3,3,0.714286,0,0,0.003084,0
1173,8137EAA7,3,2,5,1,19,0.008792,0.000011,0.050259
1174,7FEC7915,0,1,1,1,0,0,0,0
1175,7FB2FF44,0,1,1,1,0,0,0,0
1176,6B22C8EC,0,1,1,1,0,0,0.000004,0
1177,7BC295AA,4,1,5,1,3,0.000003,0,0.030427
1178,7D45364D,1,1,2,1,0,0,0,0.006286
1179,7FDC775A,1,0,1,0,0,0,0,0.011568
1180,7C74B091,1,2,3,0.75,3,0.008585,0.000162,0.006286
1181,7D3A3AA6,0,1,1,0.666667,0,0,0.000489,0
1182,598A4A59,2,0,2,0,0,0,0,0.017854
1183,75AF4CCE,0,1,1,0.6,0,0,0,0
1184,7894EE58,0,2,2,1,0,0,0.000004,0
1185,797CB60C,0,2,2,1,0,0,0.000095,0
1186,810A9517,0,1,1,1,0,0,0,0
1187,5D0C249E,3,0,3,0,0,0,0,0.018859
1188,5B09CA4B,1,0,1,0,0,0,0,0.006286
1189,7AB81937,5,0,5,0,0,0.024982,0,0.103903
1190,79034CC4,0,1,1,1,0,0,0.08476,0
1191,75FA37EA,0,1,1,1,0,0,0,0
1192,78F9B657,1,0,1,0,0,0,0,0.006286
1193,77C2E9E1,1,1,2,1,12,0.000002,0.000102,0.061421
1194,6EDA02F5,2,0,2,0,0,0.000105,0,0.060832
1195,7F35DEAF,3,0,3,0,0,0,0,0.029422
1196,792EC3C5,1,1,2,1,2,0,0.047704,0.019045
1197,7D7DA5B1,0,5,5,0.666667,0,0,0.000005,0
1198,78313546,1,0,1,0,0,0,0,0.006286
1199,79810AC9,4,0,4,0,0,0,0,0.035709
1200,7F7620B7,0,1,1,0.372549,0,0,0.000003,0
1201,80794964,2,4,6,0.642857,15,0.000662,0.006613,0.012573
1202,7DDFE224,4,1,5,1,11,0.000689,0.000002,0.066217
1203,7CEF0A95,2,1,3,1,3,0,0,0.017854
1204,5F756176,0,7,7,0.6875,0,0,0.002438,0
1205,7B3B2479,0,1,1,1,0,0,0,0
1206,7E3C0F02,1,0,1,0,0,0,0,0.006286
1207,816A29E0,2,0,2,0,0,0.000091,0,0.04072
1208,7D3FB145,1,0,1,0,0,0,0,0.006286
1209,81657D72,0,2,2,0.5,0,0,0,0
1210,7735E9C4,6,1,7,1,6,0.001335,0.000004,0.058844
1211,80605416,0,1,1,1,0,0,0.08476,0
1212,76507121,2,0,2,0,0,0,0,0.012573
1213,822EADB1,0,2,2,0.75,0,0,0.085718,0
1214,75D3CC03,1,1,2,0.666667,2,0,0,0.006286
1215,7C82CB74,1,0,1,0,0,0,0,0.006286
1216,7E9D53A7,0,1,1,1,0,0,0,0
1217,792B7C1E,0,2,2,1,0,0,0.085621,0
1218,828B43F4,0,4,4,0.466667,0,0,0.055049,0
1219,7D85A6C9,27,1,28,1,37,0.063169,0.002008,0.301606
1220,7BD6961E,0,1,1,1,0,0,0,0
1221,7CC97970,0,1,1,0.666667,0,0,0.000023,0
1222,79028FD2,2,0,2,0,0,0.004882,0,0.02005
1223,79A0A3E7,0,1,1,0.6,0,0,0,0
1224,22B2CF0D,0,1,1,0.357143,0,0,0,0
1225,7A58B9AD,6,1,7,1,17,0.009629,0,0.118971
1226,5D9DE544,0,1,1,1,0,0,0,0
1227,7E1EC1D1,0,1,1,0.6,0,0,0,0
1228,7F3C8BD6,0,2,2,0.75,0,0,0.000002,0
1229,7C0ECEAE,1,0,1,0,0,0,0,0.011568
1230,7C9D8062,3,0,3,0,0,0,0,0.029422
1231,7A03EEC3,1,0,1,0,0,0,0,0.011568
1232,78663BE6,1,1,2,1,0,0,0,0.006286
1233,79F45FF9,0,1,1,1,0,0,0,0
1234,7DA8E512,1,0,1,0,0,0,0,0.006286
1235,7AF64EE5,1,1,2,0.666667,1,0.008585,0,0.006286
1236,75F1E2FF,1,2,3,1,3,0.000003,0.000029,0.016849
1237,7D6C9B88,5,0,5,0,0,0.000004,0,0.057839
1238,7E8C2B2D,1,2,3,0.571429,4,0,0.000001,0.006286
1239,7C3739ED,0,3,3,0.8,0,0,0,0
1240,5DB3C18E,0,2,2,1,0,0,0,0
1241,79FF3343,0,1,1,1,0,0,0.08476,0
1242,7E4CB1F1,0,1,1,1,0,0,0.08476,0
1243,7F9A4BAB,6,1,7,1,0,0.000133,0.000183,0.066321
1244,76B75C7C,1,0,1,0,0,0,0,0.006286
1245,7C36ED7D,1,0,1,0,0,0,0,0.006286
1246,797C146F,1,0,1,0,0,0,0,0.006286
1247,7CF95209,1,8,9,0.64,7,0.000504,0.01478,0.006286
1248,757A4674,0,2,2,1,0,0,0.059927,0
1249,79E15043,1,0,1,0,0,0,0,0.011568
1250,7A54F480,0,1,1,1,0,0,0.08476,0
1251,787094D4,1,0,1,0,0,0,0,0.006286
1252,7631F668,0,2,2,0.75,0,0,0.000021,0
1253,80A19CD4,4,0,4,0,0,0,0,0.043185
1254,805ED9C0,0,2,2,1,0,0,0.000982,0
1255,76A23D48,1,0,1,0,0,0,0,0.006286
1256,753B4F38,0,1,1,1,0,0,0,0
1257,7A6DE10A,0,4,4,0.6,0,0,0.000099,0
1258,5ACA35DB,5,2,7,1,31,0.000199,0.001668,0.086567
1259,7AAFD1E0,0,3,3,1,0,0,0.086552,0
1260,7F1D478E,3,0,3,0,0,0,0,0.036899
1261,7DD9BFBA,1,2,3,0.75,3,0,0.0064,0.006286
1262,793EFB94,0,4,4,1,0,0,0,0
1263,7A773210,0,1,1,1,0,0,0,0
1264,7E41BF23,4,0,4,0,0,0,0,0.025146
1265,770F9EA6,0,3,3,1,0,0,0.000081,0
1266,785FAEA5,1,0,1,0,0,0,0,0.006286
1267,760B70CB,9,3,12,1,25,0.064499,0.144687,0.097939
1268,8162E57B,2,3,5,0.8,3,0,0,0.017854
1269,798E0563,1,1,2,0.666667,1.5,0,0,0.006286
1270,7C232951,0,1,1,0.333333,0,0,0,0
1271,7794FD26,0,1,1,1,0,0,0,0
1272,5EFE9486,0,1,1,1,0,0,0,0
1273,7F8A3005,18,0,18,0,0,0.000016,0,0.21245
1274,801BF0B3,1,1,2,1,1,0,0,0.006286
1275,794BB377,1,0,1,0,0,0,0,0.006286
1276,76770DDE,0,4,4,0.642857,0,0,0.057876,0
1277,79E1E6A6,5,2,7,0.75,18,0.000007,0.001593,0.036714
1278,768CE5BC,0,1,1,1,0,0,0,0
1279,7E51C7A6,1,3,4,0.625,2,0,0.000026,0.006286
1280,7580CC28,0,1,1,0.666667,0,0,0.003396,0
1281,7DB9099F,5,0,5,0,0,0,0,0.041995
1282,80B12563,0,1,1,1,0,0,0.08476,0
1283,7B237078,0,2,2,0.75,0,0,0,0
1284,3BA3EA63,0,2,2,0.555556,0,0,0,0
1285,7C2BABA0,1,0,1,0,0,0.004832,0,0.011568
1286,7EEDDB68,0,3,3,1,0,0,0,0
1287,80CDC4C4,0,2,2,1,0,0,0.132464,0
1288,7E99B753,0,1,1,0.666667,0,0,0.002418,0
1289,7E45F77D,0,1,1,0.666667,0,0,0,0
1290,7CE80EB4,1,0,1,0,0,0,0,0.016849
1291,7DFFDE85,1,2,3,1,2,0,0.048189,0.006286
1292,79F1432A,0,1,1,1,0,0,0.000026,0
1293,7962F7E6,0,1,1,1,0,0,0,0
1294,7728182E,1,0,1,0,0,0.000002,0,0.029607
1295,7C10251E,1,0,1,0,0,0,0,0.013763
1296,7CC14943,0,1,1,1,0,0,0,0
1297,7F912011,1,0,1,0,0,0,0,0.006286
1298,76C904B3,3,0,3,0,0,0,0,0.018859
1299,427F3C00,0,2,2,0.464286,0,0,0.000019,0
1300,7EB87D4F,0,1,1,1,0,0,0,0
1301,793653B7,5,3,8,0.714286,25,0.000988,0.006567,0.054753
1302,0168E905,0,2,2,0.75,0,0,0,0
1303,5ABD6481,0,1,1,1,0,0,0.047704,0
1304,804C16DB,0,1,1,0.666667,0,0,0.006334,0
1305,7917D3AA,84,0,84,0,0,0.845295,0,1
1306,7DF8B682,0,1,1,1,0,0,0.08476,0
1307,76BD090B,0,1,1,0.6,0,0,0,0
1308,7518561D,0,1,1,1,0,0,0.000011,0
1309,7564FDD9,4,2,6,0.555556,17,0.00001,0.000001,0.025146
1310,78D49579,10,0,10,0,0,0.009651,0,0.107458
1311,7F8E89FA,0,1,1,1,0,0,0.000014,0
1312,7E7DDEC5,0,1,1,0.666667,0,0,0.000003,0
1313,773722F6,1,0,1,0,0,0.000245,0,0.006286
1314,79628170,1,0,1,0,0,0,0,0.006286
1315,7654C3ED,1,0,1,0,0,0,0,0.022131
1316,79CA65A9,0,1,1,1,0,0,0,0
1317,80E9AA4F,0,1,1,1,0,0,0.001651,0
1318,80E47E3D,0,3,3,0.714286,0,0,0,0
1319,7A7551EF,0,1,1,1,0,0,0,0
1320,7526D9EF,0,1,1,1,0,0,0.047704,0
1321,7856282C,1,0,1,0,0,0,0,0.006286
1322,77255A53,2,0,2,0,0,0,0,0.065994
1323,6F784C2B,1,0,1,0,0,0,0,0.006286
1324,7983445B,1,3,4,0.666667,0,0.009423,0.091234,0.006286
1325,7961548A,0,1,1,1,0,0,0,0
1326,79DC3F9D,0,1,1,1,0,0,0,0
1327,81867388,0,1,1,0.571429,0,0,0,0
1328,7C2CFB06,2,0,2,0,0,0,0,0.012573
1329,80E8291A,2,3,5,0.8,7,0,0.000029,0.012573
1330,254FD925,0,1,1,1,0,0,0,0
1331,7C33175E,0,2,2,0.666667,0,0,0.000152,0
1332,7D0C088E,0,2,2,0.571429,0,0,0.000001,0
1333,76E2364F,0,1,1,1,0,0,0.00061,0
1334,7F747767,0,2,2,0.75,0,0,0.000004,0
1335,7B558736,0,1,1,0.545455,0,0,0.000079,0
1336,7BF944E8,0,1,1,1,0,0,0,0
1337,7F7167D1,4,1,5,0.666667,15.5,0,0,0.053748
1338,78CFD675,0,3,3,0.454545,0,0,0.000005,0
1339,479F43B0,1,0,1,0,0,0,0,0.006286
1340,76C60676,0,2,2,0.666667,0,0,0.004362,0
1341,78A7D704,0,1,1,1,0,0,0,0
1342,7EE9FCF4,5,0,5,0,0,0.001321,0,0.036714
1343,7D25216E,0,1,1,1,0,0,0,0
1344,7F384E9D,1,0,1,0,0,0,0,0.006286
1345,5ACB1267,2,0,2,0,0,0,0,0.012573
1346,8135C519,0,2,2,1,0,0,0,0
1347,7983FC16,1,1,2,1,1,0.000348,0.08476,0.006286
1348,7C385321,0,2,2,0.75,0,0,0.000023,0
1349,79CFFCCD,0,3,3,0.8,0,0,0,0
1350,7B35B4EB,2,0,2,0,0,0,0,0.012573
1351,810DBE01,1,2,3,1,2,0,0,0.006286
1352,7D15C7DD,0,1,1,1,0,0,0,0
1353,7D299B6B,1,0,1,0,0,0.000002,0,0.061421
1354,77BA1ECE,0,1,1,0.5,0,0,0.000046,0
1355,7A2A8D5F,1,0,1,0,0,0,0,0.006286
1356,7D43AE80,3,1,4,0.666667,6,0,0.000966,0.029422
1357,7DA29152,1,0,1,0,0,0.000203,0,0.01656
1358,76776EDA,3,0,3,0,0,0,0,0.047173
1359,79E73BFD,1,0,1,0,0,0,0,0.011568
1360,791EA742,2,0,2,0,0,0.000003,0,0.022245
1361,773719D8,1,1,2,1,1,0,0.08476,0.011568
1362,784BDB73,3,0,3,0,0,0.000925,0,0.029422
1363,78B70189,0,1,1,1,0,0,0.000011,0
1364,7F4E7F7C,0,1,1,1,0,0,0.000968,0
1365,7C9DF954,0,1,1,1,0,0,0.08476,0
1366,77AA940F,0,2,2,1,0,0,0,0
1367,78D8F929,1,0,1,0,0,0,0,0.006286
1368,7FC151DF,0,1,1,1,0,0,0,0
1369,5C8EF4F9,0,4,4,0.7,0,0,0,0
1370,7ED6BA01,0,1,1,0.6,0,0,0.007839,0
1371,7B6C4D19,0,1,1,1,0,0,0.000017,0
1372,7F138280,0,1,1,1,0,0,0,0
1373,79237B2F,1,0,1,0,0,0,0,0.006286
1374,7C40AEF6,0,2,2,0.75,0,0,0.000096,0
1375,76BFB96C,3,0,3,0,0,0.00025,0,0.045266
1376,7A2ACB56,0,1,1,1,0,0,0,0
1377,78BEDEBD,0,2,2,0.75,0,0,0.000014,0
1378,7B364F6F,0,1,1,0.666667,0,0,0,0
1379,7C431BC5,1,0,1,0,0,0,0,0.006286
1380,7990C51E,2,0,2,0,0,0,0,0.012573
1381,7B10868D,0,1,1,1,0,0,0.047704,0
1382,84349968,0,4,4,0.615385,0,0,0.000005,0
1383,7B94261F,2,1,3,1,3,0,0.000017,0.017854
1384,8009F4D0,0,1,1,1,0,0,0,0
1385,752CDBA5,2,0,2,0,0,0.000002,0,0.067707
1386,49249541,0,1,1,1,0,0,0.00005,0
1387,75E46F93,2,0,2,0,0,0.00019,0,0.028417
1388,7CA0627A,0,4,4,1,0,0,0,0
1389,78907943,1,2,3,1,0,0,0.000002,0.014365
1390,794ED06C,0,2,2,1,0,0,0.01477,0
1391,78846318,2,4,6,0.5,26.583333,0.000121,0.000239,0.017854
1392,7F98AE77,1,0,1,0,0,0,0,0.032116
1393,7D531021,0,1,1,1,0,0,0.000183,0
1394,7881B8BF,0,2,2,0.571429,0,0,0.000001,0
1395,80380B97,0,1,1,1,0,0,0,0
1396,8051E878,0,2,2,1,0,0,0.00003,0
1397,79226F64,0,1,1,0.666667,0,0,0.000023,0
1398,76290CB5,1,0,1,0,0,0,0,0.068388
1399,77C7A6A6,0,1,1,1,0,0,0,0
1400,7AC7380A,0,4,4,0.75,0,0,0.000001,0
1401,76E49390,4,2,6,1,8,0,0.000001,0.030427
1402,84F4ADFA,1,0,1,0,0,0,0,0.006286
1403,80A4A55C,1,0,1,0,0,0,0,0.006286
1404,8067E040,1,0,1,0,0,0.013417,0,0.006286
1405,75C3B9F4,0,3,3,1,0,0,0.000001,0
1406,7A0D4787,0,1,1,0.5,0,0,0.000588,0
1407,7B565A5F,0,1,1,1,0,0,0,0
1408,7DC11879,1,0,1,0,0,0,0,0.029319
1409,5B53B76E,1,0,1,0,0,0,0,0.006286
1410,7D563004,1,0,1,0,0,0.00009,0,0.006286
