Id,Label,indegree,outdegree,Degree,closnesscentrality,betweenesscentrality,Authority,Hub,eigencentrality
0,7DF36EC7,5,1,6,0.5,11.033333,0,0,0.071152
1,792492AC,1,3,4,1,3,0,0,0.003312
2,787C9BE4,1,1,2,1,10,0,0,0.011058
3,76836EB8,1,0,1,0,0,0,0,0.003312
4,79B01C10,0,1,1,0.571429,0,0,0,0
5,7973D3A6,0,1,1,1,0,0,0,0
6,76DEE4D6,1,0,1,0,0,0,0,0.003312
7,7E685C4B,0,3,3,1,0,0,0,0
8,7DAADD91,0,1,1,1,0,0,0,0
9,7755B8FB,1,0,1,0,0,0,0,0.00717
10,7F2B7315,0,1,1,1,0,0,0,0
11,80B765CB,0,7,7,0.4375,0,0,0,0
12,5AE71047,0,1,1,1,0,0,0,0
13,800E298A,0,3,3,0.5625,0,0,0,0
14,7C50BEAE,0,2,2,0.444444,0,0,0,0
15,80EB7470,0,2,2,0.545455,0,0,0,0
16,7929F097,1,0,1,0,0,0,0,0.003312
17,7D9D9127,0,1,1,1,0,0,0,0
18,7A74B335,4,3,7,0.8,10,0,0,0.015176
19,7DF460AF,1,0,1,0,0,0,0,0.005241
20,79ED0DA2,1,0,1,0,0,0,0,0.003312
21,7EB9B2FB,3,1,4,1,4,0,0,0.011865
22,7850A3FB,0,1,1,1,0,0,0,0
23,78ABC8F7,1,0,1,0,0,0,0,0.003312
24,7E217656,0,4,4,1,0,0,0,0
25,782472C2,1,0,1,0,0,0,0,0.003312
26,758ACE97,0,2,2,0.353659,0,0,0,0
27,76A2A0CB,0,1,1,1,0,0,0,0
28,7F6B6262,0,1,1,1,0,0,0,0
29,7D1FEF9E,0,1,1,1,0,0,0,0
30,7E5685FC,0,2,2,1,0,0,0,0
31,778872D3,1,0,1,0,0,0,0,0.003312
32,6CD7E7AA,0,1,1,1,0,0,0,0
33,799DB7AC,0,3,3,0.418182,0,0,0,0
34,8069D742,6,0,6,0,0,0,0,0.041223
35,806A0D34,0,5,5,0.329412,0,0,0,0
36,81658EF1,0,1,1,0.32,0,0,0,0
37,79604CE3,1,0,1,0,0,0,0,0.003312
38,7F5E29CC,0,2,2,0.75,0,0,0,0
39,7FEF845B,0,3,3,0.5,0,0,0,0
40,770149E4,0,7,7,0.410405,0,0,0,0
41,7EC4DA6F,0,1,1,1,0,0,0,0
42,77275E8E,2,0,2,0,0,0,0,0.011038
43,78BFED56,2,0,2,0,0,0,0,0.008553
44,7BA5BA27,1,0,1,0,0,0,0,0.003312
45,79DD9823,2,0,2,0,0,0,0,0.006624
46,7C22060E,1,0,1,0,0,0,0,0.003312
47,7D60A24A,1,0,1,0,0,0,0,0.038219
48,7760763E,0,1,1,1,0,0,0,0
49,5A3CB81D,3,0,3,0,0,0,0,0.014349
50,77CC69F1,1,1,2,0.6,0,0,0,0.009655
51,7820028A,0,1,1,0.666667,0,0,0,0
52,62B56169,3,0,3,0,0,0,0,0.030579
53,7D0A6CFC,3,2,5,1,7.666667,0,0,0.018763
54,8043D53F,2,4,6,0.833333,7,0,0,0.006624
55,7EB24540,0,1,1,0.666667,0,0,0,0
56,7DBB5083,0,1,1,1,0,0,0,0
57,8025DD56,0,1,1,1,0,0,0,0
58,78F70C0D,1,2,3,0.6,3,0,0,0.003312
59,773086D1,2,0,2,0,0,0,0,0.009108
60,7DA7A375,0,1,1,1,0,0,0,0
61,7B5A857A,0,8,8,1,0,0,0,0
62,7661A129,0,1,1,0.6,0,0,0,0
63,767FE431,1,0,1,0,0,0,0,0.003312
64,80868339,0,2,2,1,0,0,0,0
65,5D0326A9,0,5,5,0.857143,0,0,0,0
66,7A0AD406,1,0,1,0,0,0,0,0.003312
67,803E317E,0,1,1,1,0,0,0,0
68,7CAF64FF,2,0,2,0,0,0,0,0.006624
69,79AD4812,1,0,1,0,0,0,0,0.003312
70,80B18D73,0,1,1,0.444444,0,0,0,0
71,7FB62CDA,0,1,1,0.666667,0,0,0,0
72,7DE7A6BA,0,2,2,1,0,0,0,0
73,816FC85A,0,1,1,1,0,0,0,0
74,7BA3F88A,3,0,3,0,0,0,0,0.009935
75,7A07FD83,1,0,1,0,0,0,0,0.003312
76,7FC0BBD5,0,4,4,0.75,0,0,0,0
77,61C91D04,1,0,1,0,0,0,0,0.003312
78,75304DD0,1,0,1,0,0,0,0,0.003312
79,760B21C9,0,1,1,1,0,0,0,0
80,7BC56C67,8,0,8,0,0,0,0,0.032282
81,7C3A1350,3,0,3,0,0,0,0,0.022727
82,814B4F50,0,1,1,1,0,0,0,0
83,77A57F6D,1,0,1,0,0,0,0,0.007726
84,7CF3D404,0,2,2,0.75,0,0,0,0
85,8028F1D4,0,5,5,0.465517,0,0,0.000002,0
86,79B10F45,0,1,1,1,0,0,0,0
87,7FA93AB6,1,0,1,0,0,0,0,0.003312
88,799C8040,0,8,8,0.41,0,0,0,0
89,7A845BB3,2,4,6,0.535714,31.166667,0,0,0.012967
90,7E3FAFBD,1,2,3,1,1,0,0,0.003312
91,61F8ACEC,1,1,2,1,1,0,0,0.003312
92,7707ED71,0,1,1,1,0,0,0,0
93,7F28B6BD,2,0,2,0,0,0,0,0.008553
94,76BB17B1,0,4,4,0.833333,0,0,0,0
95,8171EE8F,1,1,2,1,1,0,0,0.003312
96,5A484C04,0,5,5,1,0,0,0,0
97,7DBB1382,0,1,1,1,0,0,0,0
98,8063D6D9,2,0,2,0,0,0,0,0.010482
99,81690364,0,1,1,0.666667,0,0,0,0
100,7C587175,0,2,2,1,0,0,0,0
101,8431EC09,1,0,1,0,0,0,0,0.005796
102,76F9F6F5,1,0,1,0,0,0,0,0.003312
103,0BDBF01A,1,0,1,0,0,0,0,0.009655
104,7BAB8908,1,0,1,0,0,0,0,0.005241
105,7909C966,0,1,1,1,0,0,0,0
106,7C785508,0,2,2,1,0,0,0,0
107,7788C9AA,1,1,2,1,0,0,0,0.003312
108,7DCEF8B8,5,4,9,0.666667,26.5,0,0,0.022347
109,81073AB6,2,0,2,0,0,0,0,0.011038
110,7DD2D655,0,1,1,1,0,0,0,0
111,7A20DB16,1,0,1,0,0,0,0,0.003312
112,763610B8,2,0,2,0,0,0,0,0.006624
113,7E5FC92B,0,1,1,1,0,0,0,0
114,796F9642,0,2,2,0.466667,0,0,0,0
115,813AB102,1,0,1,0,0,0,0,0.003312
116,7BE35ADB,1,0,1,0,0,0,0,0.003312
117,7F90422D,3,0,3,0,0,0,0,0.009935
118,7A3B791B,1,0,1,0,0,0,0,0.003312
119,7513C014,0,1,1,1,0,0,0,0
120,79D665A1,1,0,1,0,0,0,0,0.008837
121,77276B69,0,3,3,0.482759,0,0,0,0
122,79034B64,1,0,1,0,0,0,0,0.005241
123,77388FEF,0,1,1,1,0,0,0,0
124,7F8F2878,0,1,1,1,0,0,0,0
125,61299CE8,2,0,2,0,0,0,0,0.013522
126,76CB0C7F,1,1,2,1,1,0,0,0.003312
127,7893EE42,0,1,1,1,0,0,0,0
128,8006CB80,0,4,4,0.75,0,0,0,0
129,7D571320,0,1,1,1,0,0,0,0
130,7EA8ED22,1,0,1,0,0,0,0,0.003312
131,7F640A5B,0,1,1,0.454545,0,0,0,0
132,7FB5CBD5,1,0,1,0,0,0,0,0.003312
133,80D09525,1,0,1,0,0,0,0,0.003312
134,75A4F962,0,2,2,1,0,0,0,0
135,7654B78A,0,3,3,0.714286,0,0,0,0
136,7C0D0C2D,0,2,2,1,0,0,0,0
137,810E31D3,5,0,5,0,0,0,0,0.024832
138,778CBF96,1,0,1,0,0,0,0,0.005241
139,758CF587,1,0,1,0,0,0,0,0.003312
140,5882E5FE,5,0,5,0,0,0,0,0.062462
141,7599FF0D,2,0,2,0,0,0,0,0.008553
142,7B99B309,0,1,1,1,0,0,0,0
143,7A16CA36,0,1,1,1,0,0,0,0
144,7771B810,1,0,1,0,0,0,0,0.003312
145,7B1C33C3,0,1,1,1,0,0,0,0
146,7BCA6CEA,1,0,1,0,0,0,0,0.00717
147,787BF7EA,2,3,5,1,4,0,0,0.006624
148,7B3BAC9E,3,0,3,0,0,0,0,0.01242
149,7B9DFEA3,1,0,1,0,0,0,0,0.003312
150,77FC5BBA,6,0,6,0,0,0,0,0.054432
151,7DA9A2D0,1,1,2,0.666667,0,0,0,0.003312
152,800E3D8E,0,1,1,1,0,0,0,0
153,7FC9BA2C,0,1,1,1,0,0,0,0
154,80B9B0A4,0,1,1,1,0,0,0,0
155,7FC3C5C7,3,0,3,0,0,0,0,0.014349
156,80BB4578,1,1,2,1,1,0,0,0.003312
157,0B79EDCE,1,0,1,0,0,0,0,0.003312
158,7D54F80F,1,0,1,0,0,0,0,0.003312
159,7FF6F5B3,0,1,1,1,0,0,0,0
160,7E2EB6CD,3,0,3,0,0,0,0,0.011865
161,0A04AC8D,0,6,6,0.875,0,0,0,0
162,7D7AB29C,2,1,3,1,4,0,0,0.012412
163,81296D3F,0,1,1,0.368421,0,0,0,0
164,7D21CA57,0,1,1,0.6,0,0,0,0
165,7E5AE80B,1,3,4,0.4,21,0,0,0.005241
166,7AED4F14,0,1,1,1,0,0,0,0
167,7F900203,0,1,1,1,0,0,0,0
168,7AB132E9,14,1,15,0.571429,13.15,0.149856,0.018145,0.208705
169,77A1EE7B,76,3,79,0.8,556,0,0,1
170,76CE1155,1,0,1,0,0,0,0,0.005241
171,7B15869E,0,5,5,0.647059,0,0,0.096836,0
172,7A433D97,1,1,2,1,0.333333,0.009709,0.031718,0.003312
173,597AFCE3,0,3,3,1,0,0,0,0
174,7D328B2B,1,0,1,0,0,0,0,0.003312
175,762EBA42,1,0,1,0,0,0,0,0.003312
176,815E152B,0,1,1,1,0,0,0,0
177,8123F68F,2,4,6,1,27,0.000003,0,0.016826
178,7C1CA88F,2,2,4,0.6,0.333333,0.054587,0.09935,0.024385
179,75274838,1,2,3,0.545455,1,0,0,0.003312
180,7E583612,0,1,1,1,0,0,0,0
181,7B52059B,0,4,4,0.555556,0,0,0,0
182,0C2C23F1,1,0,1,0,0,0,0,0.003312
183,7FA50D0D,1,0,1,0,0,0,0,0.003312
184,7F7CC13A,1,0,1,0,0,0,0,0.003312
185,7A48D4CC,1,0,1,0,0,0,0,0.003312
186,0C3FCF90,4,0,4,0,0,0.00001,0,0.043169
187,7C8F6F42,1,0,1,0,0,0,0,0.003312
188,7EC2B972,1,2,3,0.6,6.5,0,0,0.00717
189,8089E3DE,0,1,1,1,0,0,0,0
190,7BEE46C8,2,0,2,0,0,0,0,0.010482
191,7D5FFB3F,0,1,1,1,0,0,0,0
192,8120FCF5,3,0,3,0,0,0,0,0.009935
193,77F5E289,1,0,1,0,0,0,0,0.013356
194,1214DEF4,1,0,1,0,0,0,0,0.003312
195,7A32A4FB,2,0,2,0,0,0,0,0.006624
196,80EE195B,0,5,5,0.4375,0,0,0,0
197,772E0802,3,0,3,0,0,0,0,0.015723
198,799541C6,0,1,1,1,0,0,0,0
199,7C3B5D50,6,0,6,0,0,0,0,0.0218
200,7B6DBAFB,3,0,3,0,0,0,0,0.014349
201,79BCFA70,3,0,3,0,0,0,0,0.011865
202,5FB7D46F,1,0,1,0,0,0,0,0.003312
203,7A4968F0,5,1,6,0.416667,3.833333,0.053208,0.015214,0.036054
204,7CAA5841,1,0,1,0,0,0,0,0.00717
205,81B07CBE,3,0,3,0,0,0,0,0.009935
206,7A2FC900,5,0,5,0,0,0,0,0.026761
207,7ACAD034,1,1,2,1,1,0,0,0.003312
208,706998A4,3,0,3,0,0,0,0,0.009935
209,785E5E09,1,0,1,0,0,0,0,0.003312
210,7C596753,0,1,1,1,0,0,0,0
211,767B6448,2,1,3,1,2,0,0,0.006624
212,7A9BBA12,0,4,4,0.413793,0,0,0,0
213,7F24809E,1,1,2,1,1,0,0,0.003312
214,81D69E3F,1,0,1,0,0,0,0,0.005241
215,7F60B6C3,5,2,7,1,4.5,0,0,0.022902
216,80456B09,0,3,3,0.538462,0,0,0,0
217,5A0DF14C,0,1,1,1,0,0,0,0
218,7A98455C,2,3,5,0.8,4,0,0,0.006624
219,7FA739ED,0,2,2,1,0,0,0,0
220,7F964E42,1,0,1,0,0,0,0,0.003312
221,80551F92,1,3,4,0.8,8,0,0,0.005241
222,78CE14CD,0,2,2,0.391304,0,0,0,0
223,804BC14C,0,1,1,1,0,0,0,0
224,7C80CB72,0,1,1,0.555556,0,0,0,0
225,806F2638,2,2,4,1,12,0.000005,0,0.015452
226,808D55D2,1,0,1,0,0,0,0,0.003312
227,8131EEC3,0,1,1,1,0,0,0,0
228,7F046AD1,1,0,1,0,0,0,0,0.005241
229,80B731B5,1,1,2,1,1,0,0,0.003312
230,7D8822EB,0,1,1,0.6,0,0,0,0
231,7BC05815,3,0,3,0,0,0,0,0.013794
232,752A6215,0,1,1,0.666667,0,0,0,0
233,7B970CC7,2,0,2,0,0,0,0,0.014896
234,7CFCD02D,1,0,1,0,0,0,0,0.005917
235,7C274D98,2,7,9,0.818182,15,0,0.000039,0.008553
236,7859B5A2,2,0,2,0,0,0,0,0.006624
237,7F9B1B96,0,4,4,0.535714,0,0,0.000029,0
238,8026BF90,11,0,11,0,0,0,0,0.097739
239,7771A931,1,0,1,0,0,0,0,0.008837
240,7F5B23B9,2,0,2,0,0,0,0,0.008553
241,7B94FDEB,2,0,2,0,0,0,0,0.011038
242,7E359C2A,0,1,1,1,0,0,0,0
243,7B23D7AC,3,0,3,0,0,0,0,0.016384
244,815FF074,3,4,7,0.416667,26.333333,0,0,0.009935
245,7AB7B2D5,4,0,4,0,0,0,0,0.017661
246,7A4EA807,3,0,3,0,0,0,0,0.011865
247,7F3AFE3C,2,4,6,1,5.5,0,0,0.006624
248,7F389218,1,0,1,0,0,0,0,0.010052
249,8006C671,0,1,1,1,0,0,0,0
250,7DC981DF,1,0,1,0,0,0,0,0.003312
251,803260AA,1,0,1,0,0,0,0,0.005241
252,75C88FD6,1,0,1,0,0,0,0,0.003312
253,77776224,9,5,14,0.727273,271.991667,0,0,0.230867
254,7919D7D6,0,1,1,1,0,0,0,0
255,75FFC80A,1,0,1,0,0,0,0,0.003312
256,7A7EEBD0,1,2,3,1,2,0,0,0.003312
257,7E472010,1,2,3,1,2,0,0,0.003312
258,7DBF05C0,2,0,2,0,0,0,0,0.006624
259,7850C398,0,4,4,0.75,0,0,0,0
260,7F9D1B13,0,1,1,1,0,0,0,0
261,787327F7,1,0,1,0,0,0,0,0.003312
262,7D343418,0,1,1,0.666667,0,0,0,0
263,7CE54230,1,0,1,0,0,0,0,0.003312
264,791B9B86,2,0,2,0,0,0,0,0.008553
265,7FE12712,2,0,2,0,0,0.000008,0,0.012967
266,5EE72C45,3,2,5,1,10,0,0,0.014905
267,7E4385EB,0,6,6,0.369748,0,0,0,0
268,75BDAEB2,0,3,3,1,0,0,0,0
269,7E78846E,0,1,1,1,0,0,0,0
270,79DE0C6B,0,1,1,0.5,0,0,0,0
271,7A7319B5,1,0,1,0,0,0,0,0.003312
272,80FE00FA,1,2,3,0.545455,6,0,0,0.003312
273,7AA37DA2,1,0,1,0,0,0,0,0.003312
274,7B84C7B0,10,1,11,1,117.089683,0,0,0.514413
275,78F8C352,0,1,1,1,0,0,0,0
276,809F65C6,16,2,18,0.555556,78.5,0,0,0.080291
277,0C0441F7,1,0,1,0,0,0,0,0.003312
278,809EA145,0,1,1,0.454545,0,0,0,0
279,805C1B1F,0,4,4,0.615385,0,0,0,0
280,7EEC7438,3,1,4,0.666667,4,0,0,0.011865
281,7CF3A564,0,1,1,1,0,0,0,0
282,766FD556,1,1,2,1,1,0,0,0.003312
283,8086BCE3,0,3,3,1,0,0,0,0
284,79A33975,1,0,1,0,0,0,0,0.003312
285,80A8F624,0,2,2,0.75,0,0,0,0
286,764A7676,0,2,2,0.75,0,0,0,0
287,599A3709,11,1,12,0.6,90.019048,0,0,0.117607
288,7E6DB32D,0,1,1,1,0,0,0,0
289,81943737,1,1,2,0.666667,4,0,0,0.005241
290,7D08AEAC,1,5,6,0.289474,21,0,0,0.003312
291,811A9160,3,3,6,0.447368,50.666667,0,0,0.011865
292,7B561FC6,3,2,5,0.411765,8,0,0,0.016279
293,790EF7DB,3,0,3,0,0,0,0,0.009935
294,75D8CCFD,6,0,6,0,0,0,0,0.031183
295,7E0BABE2,0,5,5,0.7,0,0,0,0
296,790D138C,1,0,1,0,0,0,0,0.003312
297,5CCEEFAC,3,0,3,0,0,0,0,0.013794
298,789CD181,0,2,2,1,0,0,0,0
299,59B04693,1,0,1,0,0,0,0,0.006352
300,7CF09060,1,2,3,0.75,6,0,0,0.010211
301,02866F8B,1,0,1,0,0,0,0,0.003312
302,78717880,1,0,1,0,0,0,0,0.003312
303,7F1EB8B3,0,2,2,0.47619,0,0,0.000013,0
304,7764B3C6,0,1,1,1,0,0,0,0
305,7D9C22BD,1,0,1,0,0,0,0,0.009655
306,7D2DD498,0,1,1,1,0,0,0,0
307,7D29ED36,2,0,2,0,0,0,0,0.008553
308,7936B0AE,1,0,1,0,0,0,0,0.003312
309,7E937D91,0,3,3,0.403846,0,0,0,0
310,76445A4F,1,0,1,0,0,0,0,0.003312
311,75317F2A,0,1,1,1,0,0,0,0
312,7F0D6B11,1,2,3,1,2,0,0,0.003312
313,7F24127F,1,2,3,1,0,0,0,0.003312
314,7DBA2A09,0,2,2,1,0,0,0,0
315,7FBED522,1,0,1,0,0,0,0,0.003312
316,760CE828,0,1,1,1,0,0,0,0
317,7617F75A,1,0,1,0,0,0,0,0.010052
318,7FAD90B0,1,1,2,0.666667,0,0,0,0.005902
319,7B46955F,1,2,3,0.666667,2,0,0,0.003312
320,7871D48F,0,3,3,0.714286,0,0,0,0
321,7F4913F8,0,2,2,1,0,0,0,0
322,7CA27E42,3,4,7,0.7,36.333333,0,0,0.034926
323,7C3EBAE8,7,0,7,0,0,0,0,0.048799
324,7B3B3F47,1,0,1,0,0,0,0,0.011757
325,7C3514AC,1,0,1,0,0,0,0,0.005241
326,7DBD4E4C,0,1,1,1,0,0,0,0
327,7EC0F58E,0,1,1,1,0,0,0,0
328,798767E2,0,4,4,0.833333,0,0,0,0
329,7BB55432,2,1,3,1,2,0,0,0.008553
330,7B302DE2,1,0,1,0,0,0,0,0.003312
331,81BBA6EA,1,3,4,1,2,0,0,0.003312
332,81770CF3,0,2,2,0.545455,0,0,0,0
333,7A14406E,0,2,2,1,0,0,0,0
334,7FDADBCD,11,0,11,0,0,0,0,0.064948
335,76D5F9DB,6,0,6,0,0,0,0,0.070461
336,75889A77,1,0,1,0,0,0,0,0.003312
337,7F349598,0,3,3,1,0,0,0.00153,0
338,77095C0A,0,1,1,0.6,0,0,0,0
339,79E98452,0,1,1,1,0,0,0,0
340,722044F6,3,0,3,0,0,0,0,0.011865
341,7B40249C,1,0,1,0,0,0,0,0.003312
342,7D49AFF7,1,1,2,1,1,0,0,0.003312
343,753CCD24,1,0,1,0,0,0,0,0.003312
344,7E3F649D,2,1,3,1,4,0,0,0.010482
345,7EFC8B3C,1,0,1,0,0,0,0,0.003312
346,7EC1F2A3,0,1,1,0.666667,0,0,0,0
347,812F6FFB,0,1,1,1,0,0,0,0
348,79742805,1,0,1,0,0,0,0,0.003312
349,7EDE6E4E,0,2,2,0.5625,0,0,0,0
350,7F6F03C7,0,1,1,1,0,0,0,0
351,78FC42E0,0,4,4,0.39823,0,0,0,0
352,762D4256,2,3,5,1,4,0,0,0.006624
353,7E779340,2,0,2,0,0,0,0,0.010482
354,7860F8CB,1,2,3,0.75,3,0,0,0.003312
355,810425F5,1,0,1,0,0,0,0,0.005241
356,770308F5,1,0,1,0,0,0,0,0.003312
357,7C0369B2,0,1,1,0.384615,0,0,0,0
358,59391AFF,2,0,2,0,0,0,0,0.008553
359,80F8F324,3,2,5,0.5,24,0,0,0.011865
360,790B696A,0,3,3,0.529412,0,0,0,0
361,79C83872,0,1,1,0.666667,0,0,0,0
362,766C1E76,2,3,5,0.636364,10,0.000311,0.101801,0.006624
363,7607EA70,0,1,1,0.3,0,0,0,0
364,7E3D9D51,1,0,1,0,0,0,0,0.003312
365,7A7FC7F6,0,1,1,1,0,0,0,0
366,77341305,0,2,2,0.333333,0,0,0,0
367,60A75F95,1,0,1,0,0,0,0,0.003312
368,767F6811,1,0,1,0,0,0,0,0.005241
369,7E01512E,1,3,4,0.571429,3,0,0,0.003312
370,5E6E55DE,1,0,1,0,0,0,0,0.003312
371,0814314A,0,2,2,1,0,0,0,0
372,5D9AE362,0,1,1,0.375,0,0,0,0
373,7B4D3F84,1,0,1,0,0,0,0,0.003312
374,79DE33E9,9,2,11,0.555556,39.833333,0,0,0.093489
375,7C0D1837,0,1,1,1,0,0,0,0
376,7EFE8B02,2,1,3,1,2,0,0,0.006624
377,79A0C24E,0,4,4,0.359375,0,0,0,0
378,78208C94,2,0,2,0,0,0,0,0.008553
379,81189A48,0,1,1,1,0,0,0,0
380,7708B9E3,0,1,1,1,0,0,0,0
381,7AA975DA,0,1,1,1,0,0,0,0
382,6C5EF405,1,0,1,0,0,0,0,0.005241
383,7700F498,1,0,1,0,0,0,0,0.003312
384,79E2146E,1,0,1,0,0,0.000001,0,0.003312
385,7683DB36,0,3,3,0.4,0,0,0,0
386,7C24401B,1,0,1,0,0,0,0,0.003312
387,7D3D3737,6,3,9,0.8,20,0.000126,0.000002,0.019871
388,76EAA955,4,0,4,0,0,0,0,0.024005
389,8068ADA4,4,4,8,0.32,35,0,0,0.013247
390,7CFBB887,0,3,3,0.375,0,0,0,0
391,8035AC75,9,7,16,0.580645,200,0,0,0.044422
392,7B90A5CC,0,2,2,0.75,0,0,0,0
393,7EE73C7E,5,1,6,1,1.25,0,0,0.020973
394,756B855C,1,0,1,0,0,0,0,0.003312
395,798EE79D,1,0,1,0,0,0,0,0.003312
396,78EA6722,0,1,1,0.666667,0,0,0,0
397,78478D5B,1,0,1,0,0,0,0,0.003312
398,7916F4E8,1,8,9,0.62069,2.366667,0.02085,0.091716,0.003312
399,79DE8AD6,4,1,5,1,0.5,0,0,0.020251
400,75344C7D,4,0,4,0,0,0,0,0.017661
401,80F97820,0,1,1,1,0,0,0,0
402,81038255,3,0,3,0,0,0,0,0.011865
403,794C413A,1,0,1,0,0,0,0,0.003312
404,77ECDBC8,1,0,1,0,0,0,0,0.003312
405,7F90663E,3,0,3,0,0,0,0,0.009935
406,75DF8305,2,0,2,0,0,0,0,0.006624
407,6F7CE89B,0,1,1,1,0,0,0,0
408,7D200545,3,0,3,0,0,0,0,0.011865
409,802A23EC,2,0,2,0,0,0,0,0.012412
410,76839EBA,0,1,1,1,0,0,0,0
411,7B47085B,1,0,1,0,0,0,0,0.003312
412,7C74F98F,0,3,3,0.466667,0,0,0,0
413,7F772E6D,0,2,2,0.75,0,0,0,0
414,7B2B53BE,1,0,1,0,0,0,0,0.005241
415,7F0AC486,10,0,10,0,0,0,0,0.038906
416,7C5FDAD4,6,0,6,0,0,0.00008,0,0.053149
417,7F4B020B,0,6,6,0.428571,0,0,0,0
418,7C8656FF,1,0,1,0,0,0,0,0.003312
419,811185DD,0,1,1,1,0,0,0,0
420,75FDC60F,7,0,7,0,0,0,0,0.027041
421,8030A918,1,0,1,0,0,0,0,0.003312
422,0E3CF286,0,2,2,1,0,0,0,0
423,7DD5D7EC,0,1,1,0.666667,0,0,0,0
424,79C5C91C,0,2,2,1,0,0,0,0
425,77F4507C,5,0,5,0,0,0,0,0.020418
426,7F3E2B57,2,0,2,0,0,0,0,0.010324
427,7D523CBA,0,2,2,0.5,0,0,0,0
428,76E91814,1,0,1,0,0,0,0,0.003312
429,777E3382,1,0,1,0,0,0,0,0.003312
430,089472BA,2,0,2,0,0,0,0,0.017427
431,7AFFD398,0,1,1,1,0,0,0,0
432,7B4EB56E,1,0,1,0,0,0,0,0.005241
433,7F627818,1,0,1,0,0,0,0,0.003312
434,8009A0B4,1,2,3,1,3,0,0,0.005241
435,7D6CD96B,0,1,1,1,0,0,0,0
436,590A30E0,0,2,2,0.571429,0,0,0,0
437,7881476C,1,0,1,0,0,0,0,0.024113
438,7FE600B7,1,0,1,0,0,0.008001,0,0.003312
439,7F62A4D1,0,1,1,0.5,0,0,0,0
440,7E07DC16,0,2,2,0.262626,0,0,0,0
441,76124F70,0,1,1,1,0,0,0,0
442,78A62889,1,0,1,0,0,0,0,0.003312
443,76DF2FD5,1,0,1,0,0,0,0,0.007089
444,5B92A4A2,0,2,2,0.666667,0,0,0,0
445,5C96936D,0,3,3,1,0,0,0,0
446,814E5757,2,2,4,1,3,0,0,0.010482
447,76CD6313,1,0,1,0,0,0,0,0.017943
448,7CE5A831,2,0,2,0,0,0,0,0.011038
449,800DCFB0,2,0,2,0,0,0,0,0.006624
450,7B379475,1,0,1,0,0,0,0,0.003312
451,77FCE535,1,0,1,0,0,0,0,0.003312
452,7EFE2A41,0,1,1,0.310345,0,0,0,0
453,76BC9107,2,0,2,0,0,0,0,0.006624
454,78B1A004,1,0,1,0,0,0,0,0.003312
455,774B40AE,1,0,1,0,0,0,0,0.003312
456,780A6786,1,2,3,1,1,0,0,0.003312
457,7BD97331,3,0,3,0,0,0,0,0.013794
458,765499D4,1,0,1,0,0,0,0,0.003312
459,7F09E3A4,0,1,1,1,0,0,0,0
460,58E83FC4,1,0,1,0,0,0,0,0.003312
461,7857D4D2,1,0,1,0,0,0,0,0.005241
462,7DCFAF8F,3,5,8,0.7,70.5,0,0,0.026481
463,764AC02C,1,0,1,0,0,0,0,0.003312
464,7AE61C77,0,4,4,0.833333,0,0,0,0
465,7CC40EA0,1,0,1,0,0,0,0,0.003312
466,7D31379E,1,1,2,1,0.5,0,0,0.003312
467,7DBBF988,0,1,1,0.310345,0,0,0,0
468,81C1AB2A,0,2,2,0.461538,0,0,0,0
469,779FAE9F,1,0,1,0,0,0,0,0.005241
470,792EA16E,1,3,4,0.526316,3,0,0,0.003312
471,80355DB8,0,1,1,0.666667,0,0,0,0
472,7EC18CFD,1,3,4,0.529412,9,0,0,0.003312
473,7D278B3A,4,2,6,0.666667,157,0,0,0.076288
474,75D292B2,0,1,1,0.5,0,0,0,0
475,7F1FDDE0,0,1,1,1,0,0,0,0
476,7D3341C2,1,4,5,1,4,0,0.131618,0.003312
477,7A0EDDEB,1,0,1,0,0,0,0,0.003312
478,779EB9E4,1,0,1,0,0,0,0,0.003312
479,7907BCC2,1,1,2,1,1,0,0,0.003312
480,7672D7BF,2,0,2,0,0,0,0,0.006624
481,75FBE91D,0,1,1,1,0,0,0,0
482,7DAC1C2C,0,1,1,1,0,0,0,0
483,5D4839E6,0,1,1,0.375,0,0,0,0
484,7A826623,5,1,6,1,7,0,0,0.024832
485,754837CE,1,1,2,1,1,0,0,0.003312
486,7827439D,1,0,1,0,0,0,0,0.005241
487,7FECCCAA,1,0,1,0,0,0,0,0.003312
488,7B528AD4,1,0,1,0,0,0,0,0.008837
489,7D92F3C2,0,6,6,0.42623,0,0,0,0
490,7A4F7D74,0,4,4,0.7,0,0,0.160054,0
491,807FA742,0,1,1,1,0,0,0,0
492,77C1E7B4,1,0,1,0,0,0,0,0.00717
493,805F5A82,0,1,1,0.666667,0,0,0,0
494,79D03271,4,1,5,1,6,0,0,0.019035
495,7D7A87B0,0,2,2,0.441176,0,0,0.000741,0
496,80E50ABC,0,2,2,1,0,0,0,0
497,7F4B2780,3,1,4,1,2.5,0,0,0.028965
498,76180CC2,1,0,1,0,0,0,0,0.003312
499,7DC21535,0,3,3,0.714286,0,0,0,0
500,79777BBF,0,1,1,0.361111,0,0,0,0
501,05B95F11,0,1,1,1,0,0,0,0
502,7EA1A7F3,0,3,3,0.333333,0,0,0,0
503,80D8ACD4,1,1,2,1,0,0,0,0.008281
504,5CA27135,0,1,1,1,0,0,0,0
505,7D1DC994,0,1,1,0.666667,0,0,0,0
506,7BF18282,1,0,1,0,0,0,0,0.003312
507,7A153AED,1,0,1,0,0,0,0,0.003312
508,7E71D114,0,1,1,0.571429,0,0,0,0
509,7C4AADA3,0,2,2,1,0,0,0,0
510,7F23DBEE,2,3,5,0.666667,21,0,0,0.010482
511,77FDC91C,0,1,1,1,0,0,0,0
512,754661F6,3,0,3,0,0,0,0,0.011865
513,8070956C,0,1,1,0.666667,0,0,0,0
514,7FD48F94,1,0,1,0,0,0,0,0.003312
515,5DA8D990,2,0,2,0,0,0,0,0.006624
516,818B850C,2,1,3,1,13,0,0,0.014964
517,73E0F9BE,1,0,1,0,0,0,0,0.003312
518,77C2B0C9,1,0,1,0,0,0,0,0.003312
519,0DB4E02E,0,1,1,0.466667,0,0,0,0
520,795CAB36,0,1,1,1,0,0,0,0
521,5DBFB846,0,1,1,1,0,0,0,0
522,7DEF294F,0,1,1,1,0,0,0,0
523,0940E307,1,0,1,0,0,0,0,0.003312
524,7A96910D,1,0,1,0,0,0,0,0.003312
525,75E12FBF,1,0,1,0,0,0,0,0.00717
526,7800E50F,1,5,6,0.458824,39,0,0,0.003312
527,6AF10224,0,2,2,0.3,0,0,0,0
528,7EB23E39,0,1,1,1,0,0,0,0
529,75C221A8,1,0,1,0,0,0,0,0.003312
530,71F1EEE3,6,0,6,0,0,0,0,0.024285
531,7620B2C6,2,1,3,1,0,0,0,0.016112
532,7520191D,1,0,1,0,0,0,0,0.0091
533,75CC9A79,1,1,2,0.5,0,0,0,0.005241
534,7DB2DCA0,1,5,6,0.611111,11,0,0,0.003312
535,768B45E5,0,1,1,0.303571,0,0,0,0
536,5AE8E6ED,1,2,3,0.461538,4,0,0,0.005241
537,7BAC7C86,0,2,2,0.75,0,0,0,0
538,7C917AFC,1,0,1,0,0,0,0,0.003312
539,0A35C276,2,0,2,0,0,0,0,0.018018
540,76B92D7F,0,1,1,1,0,0,0,0
541,7D91800D,0,1,1,0.666667,0,0,0,0
542,7BC4AEDD,0,3,3,0.8,0,0,0,0
543,5F0BB605,2,0,2,0,0,0,0,0.006624
544,7CC83F73,1,0,1,0,0,0,0,0.00717
545,802378B9,3,3,6,1,18,0,0,0.015723
546,7B57EF13,2,0,2,0,0,0,0,0.006624
547,7EF76978,1,0,1,0,0,0,0,0.003312
548,7BCE1827,1,3,4,0.5,1,0.00957,0.092023,0.003312
549,81175435,0,1,1,0.666667,0,0,0,0
550,754BE063,6,0,6,0,0,0,0,0.043712
551,7EBE5549,0,1,1,1,0,0,0,0
552,7D518324,0,1,1,1,0,0,0,0
553,807B55E5,1,2,3,0.6,3,0,0,0.003312
554,7FB08CD2,1,0,1,0,0,0,0,0.003312
555,76053D0A,1,1,2,1,1.5,0,0,0.0091
556,7B62A595,4,0,4,0,0,0,0,0.026753
557,7C5F9FA0,3,1,4,1,3,0.00004,0.000008,0.009935
558,7D07CA6B,5,9,14,0.846154,46.5,0.028579,0.189131,0.020973
559,5C6409EA,1,0,1,0,0,0,0,0.003312
560,81708E54,0,3,3,1,0,0,0,0
561,05DCB9D8,1,0,1,0,0,0,0,0.003312
562,7DBA74F8,0,3,3,0.8,0,0,0,0
563,7DDFE8DC,1,4,5,0.75,6,0,0,0.003312
564,8170B6F0,3,0,3,0,0,0,0,0.02886
565,761FED62,1,0,1,0,0,0,0,0.003312
566,75638ED0,0,1,1,1,0,0,0,0
567,7B1252BD,2,2,4,1,8,0,0,0.010324
568,812AE5DB,0,1,1,1,0,0,0,0
569,6E549612,15,0,15,0,0,0,0,0.273944
570,23630669,0,3,3,0.636364,0,0,0.101801,0
571,7DA0B043,5,1,6,1,3,0,0,0.026761
572,815DCC45,3,0,3,0,0,0,0,0.009935
573,80F5B753,2,0,2,0,0,0,0,0.008553
574,806E20E1,2,2,4,1,5.5,0,0,0.008553
575,7E49F9F6,0,2,2,1,0,0,0,0
576,7DDEC4CA,7,4,11,0.642857,42.666667,0.000016,0.000052,0.047685
577,7EB3C444,1,0,1,0,0,0,0,0.003312
578,7F7B9B89,0,2,2,1,0,0,0,0
579,75D0765B,1,1,2,1,1,0,0,0.003312
580,75D21E9D,3,1,4,1,2,0,0,0.047375
581,75536F40,3,0,3,0,0,0,0,0.011865
582,7CF2CA6E,0,1,1,0.666667,0,0,0,0
583,595910D5,1,2,3,0.666667,4,0,0,0.003312
584,8002F382,0,3,3,0.8,0,0,0,0
585,7CCA1DEB,2,0,2,0,0,0,0,0.006624
586,80919DFF,0,1,1,1,0,0,0,0
587,7E939FD3,2,7,9,0.588235,38.94127,0,0,0.034947
588,7F964319,1,0,1,0,0,0,0,0.003312
589,7E81B869,0,1,1,1,0,0,0,0
590,7C06FFF9,2,0,2,0,0,0,0,0.006624
591,75F2B115,1,0,1,0,0,0,0,0.017215
592,7CE36E33,0,1,1,0.666667,0,0,0,0
593,76F523DD,0,2,2,0.347826,0,0,0,0
594,5E4C2AAE,0,1,1,0.458333,0,0,0,0
595,7C73F81A,0,1,1,1,0,0,0,0
596,7F29C51D,0,3,3,0.8,0,0,0,0
597,7753D24E,2,0,2,0,0,0,0,0.01724
598,78E71788,1,0,1,0,0,0,0,0.005241
599,7E1ADE08,1,0,1,0,0,0,0,0.003312
600,85EADA29,1,0,1,0,0,0,0,0.003312
601,7C770C13,0,1,1,0.416667,0,0,0.015214,0
602,7B37A10D,2,5,7,1,10,0,0,0.008553
603,75C3F1E1,1,0,1,0,0,0,0,0.003312
604,58B24AFB,2,0,2,0,0,0,0,0.006624
605,7FF4E26D,2,1,3,0.32,6,0,0,0.006624
606,7BB54A93,1,0,1,0,0,0,0,0.003312
607,7C7E2AB5,0,1,1,1,0,0,0,0
608,7E8231CE,1,0,1,0,0,0,0,0.003312
609,7DB5795B,0,1,1,1,0,0,0,0
610,816ED73C,0,1,1,1,0,0,0,0
611,76985A61,1,2,3,0.75,3,0,0,0.00717
612,7F772EAC,4,2,6,0.75,9.5,0,0,0.015176
613,75E22310,2,0,2,0,0,0,0,0.006624
614,7A08C93E,4,0,4,0,0,0,0,0.080688
615,2506D319,0,2,2,0.75,0,0,0.000004,0
616,769156E8,0,1,1,1,0,0,0,0
617,7C1F09FA,0,1,1,0.545455,0,0,0,0
618,7A44C4A0,1,0,1,0,0,0,0,0.005241
619,7CF5D409,0,1,1,0.666667,0,0,0,0
620,7D32B719,2,0,2,0,0,0,0,0.036808
621,033D4E09,1,0,1,0,0,0,0,0.00717
622,7D3A2787,1,2,3,0.4,24,0,0,0.016817
623,625AEBB1,3,0,3,0,0,0,0,0.016279
624,7FF746F7,0,3,3,0.8,0,0,0,0
625,80E50AFC,1,1,2,1,0,0,0,0.003312
626,7753A9C8,1,0,1,0,0,0,0,0.003312
627,7DD6E790,0,2,2,0.555556,0,0,0,0
628,7FB62EB9,0,1,1,1,0,0,0,0
629,81FF3A2F,0,4,4,0.571429,0,0,0,0
630,75AE4259,1,0,1,0,0,0,0,0.014174
631,753425E6,5,0,5,0,0,0,0,0.043683
632,0D597612,3,0,3,0,0,0,0,0.020243
633,7DBC7B1D,2,1,3,1,2,0,0,0.008553
634,79CC5797,1,1,2,1,1,0,0,0.003312
635,7FF40BF6,3,0,3,0,0,0,0,0.019529
636,7DF62472,0,1,1,1,0,0,0,0
637,767749F7,1,2,3,1,4,0,0,0.005241
638,7B8232BC,0,3,3,0.8,0,0,0,0
639,80A0A0A6,0,1,1,1,0,0,0,0
640,7B2A6032,3,0,3,0,0,0,0,0.011865
641,7BBB065C,0,2,2,1,0,0,0,0
642,7F4B5B61,0,2,2,1,0,0,0,0
643,7C302B1C,0,4,4,0.385965,0,0,0,0
644,7BD43C9C,0,1,1,1,0,0,0,0
645,75B649A5,0,1,1,1,0,0,0,0
646,7DA2B78B,1,1,2,1,1,0,0,0.003312
647,80CC9F2E,2,0,2,0,0,0,0,0.006624
648,7C490FF8,1,0,1,0,0,0.012111,0,0.003312
649,77D1A71D,1,0,1,0,0,0,0,0.003312
650,7B432937,0,1,1,1,0,0,0,0
651,7CE37C19,0,2,2,1,0,0,0,0
652,7607731D,0,1,1,1,0,0,0,0
653,80FE1455,1,0,1,0,0,0,0,0.003312
654,7BB25D3F,0,1,1,1,0,0,0,0
655,7D585F03,4,1,5,1,3.166667,0,0,0.027127
656,7FD73F82,28,0,28,0,0,0,0,0.229159
657,5BFAAA5E,0,1,1,0.666667,0,0,0,0
658,1749DCE0,0,3,3,0.714286,0,0,0,0
659,813EF15F,0,3,3,0.477273,0,0,0.024904,0
660,7D0BFC7C,0,1,1,1,0,0,0,0
661,7D14388B,0,1,1,1,0,0,0,0
662,585EE77C,1,0,1,0,0,0,0,0.003312
663,8159AB0B,0,1,1,1,0,0,0,0
664,7F373FA1,0,9,9,0.666667,0,0,0,0
665,7EB64CDA,1,0,1,0,0,0,0,0.008281
666,7FB31A21,0,1,1,0.37037,0,0,0,0
667,7D669CC8,7,0,7,0,0,0,0,0.040283
668,8096807E,0,1,1,1,0,0,0,0
669,7FB6C2C7,0,1,1,1,0,0,0,0
670,7F0638F2,1,0,1,0,0,0,0,0.003312
671,609C8FEC,1,0,1,0,0,0,0,0.003312
672,798131F9,2,0,2,0,0,0,0,0.006624
673,815A01A2,1,0,1,0,0,0,0,0.003312
674,78C54251,0,2,2,0.666667,0,0,0,0
675,7FB9D52A,1,0,1,0,0,0,0,0.00717
676,7C248E40,1,1,2,1,1,0,0,0.003312
677,7762CAA9,3,5,8,0.777778,4.35,0.03394,0.16393,0.011865
678,791DD789,3,4,7,0.666667,13,0,0,0.01242
679,7991D99D,0,1,1,1,0,0,0,0
680,7B44DA54,0,2,2,0.392157,0,0,0,0
681,80664812,0,1,1,1,0,0,0.031718,0
682,7685611B,0,3,3,1,0,0,0,0
683,5A2E025A,2,0,2,0,0,0,0,0.006624
684,7F6E918E,1,1,2,1,1,0,0,0.003312
685,76E4E805,0,1,1,1,0,0,0,0
686,7E0DDC30,0,4,4,0.52381,0,0,0,0
687,7C5DA1D6,0,1,1,1,0,0,0,0
688,7E33A157,0,2,2,0.75,0,0,0,0
689,80B9A353,3,1,4,1,2,0,0,0.011865
690,7909E79F,3,0,3,0,0,0,0,0.361604
691,7A473F5A,1,2,3,1,2,0,0,0.003312
692,7726E149,1,0,1,0,0,0,0,0.003312
693,77ACB8F8,2,0,2,0,0,0,0,0.008553
694,77516C40,0,1,1,1,0,0,0,0
695,77612515,1,0,1,0,0,0,0,0.003312
696,7D86C775,1,3,4,1,3,0,0,0.003312
697,09E401DE,2,0,2,0,0,0,0,0.006624
698,7D5F5817,1,1,2,0.666667,1,0,0,0.003312
699,8125888F,0,1,1,0.410256,0,0,0,0
700,7F428923,1,1,2,1,1,0,0,0.003312
701,7A026B74,0,2,2,0.411765,0,0,0,0
702,8165245A,4,1,5,0.5,7.5,0,0,0.015176
703,7B4C0B51,2,0,2,0,0,0,0,0.006624
704,79F13982,0,1,1,1,0,0,0,0
705,5F04DD98,3,0,3,0,0,0,0,0.015565
706,804AAE31,0,1,1,1,0,0,0,0
707,7D3F291B,0,1,1,1,0,0,0,0
708,7F701AA4,0,5,5,0.6,0,0,0,0
709,7F3F1E85,0,1,1,0.666667,0,0,0,0
710,75D93BB1,0,2,2,0.310345,0,0,0,0
711,785139AB,1,0,1,0,0,0,0,0.003312
712,7D6E056B,0,2,2,0.75,0,0,0,0
713,7DDC20A7,3,1,4,1,13.616667,0,0,0.084568
714,7DE22D75,1,4,5,1,2,0,0,0.005241
715,7F251943,1,2,3,1,2,0,0,0.003312
716,7EAA44CE,6,0,6,0,0,0,0,0.0218
717,80C760AD,0,1,1,1,0,0,0,0
718,816B6BC4,0,2,2,1,0,0,0,0
719,7ECBA8B3,0,2,2,0.6,0,0,0.071508,0
720,7B28D098,1,0,1,0,0,0,0,0.003312
721,7C9FC6B9,1,0,1,0,0,0,0,0.003312
722,7D75B3DB,0,1,1,1,0,0,0,0
723,7F5BAB15,1,4,5,0.7,9,0,0,0.005796
724,7F635FAE,1,0,1,0,0,0,0,0.003312
725,7F13081E,1,0,1,0,0,0.008001,0,0.003312
726,75ADF17D,0,1,1,1,0,0,0,0
727,7C55F516,1,0,1,0,0,0,0,0.003312
728,7F72F0AA,1,0,1,0,0,0,0,0.005241
729,7CCD6057,1,0,1,0,0,0,0,0.003312
730,7F4C049E,2,0,2,0,0,0,0,0.006624
731,7FBE62C4,2,1,3,0.38,11,0,0,0.006624
732,7B436014,1,0,1,0,0,0,0,0.003312
733,7BA6FF70,0,2,2,1,0,0,0,0
734,7B9C4BDA,1,0,1,0,0,0,0,0.003312
735,7D557757,1,0,1,0,0,0,0,0.003312
736,8051E9DF,3,7,10,0.413333,105.083333,0,0,0.011865
737,7FB80C0E,0,2,2,0.75,0,0,0,0
738,7B1638CB,1,0,1,0,0,0,0,0.003312
739,77731460,0,2,2,0.75,0,0,0,0
740,75D21289,0,3,3,0.427536,0,0,0,0
741,805A1EE8,0,1,1,1,0,0,0,0
742,7A09DF21,1,0,1,0,0,0,0,0.003312
743,766F08F8,7,0,7,0,0,0,0,0.049434
744,79D2D970,0,1,1,0.307692,0,0,0,0
745,7557975D,0,1,1,1,0,0,0.045987,0
746,81ACE14B,8,0,8,0,0,0,0,0.04415
747,8125CC55,0,1,1,1,0,0,0,0
748,7C5165F8,1,0,1,0,0,0,0,0.003312
749,761F0292,1,0,1,0,0,0,0,0.003312
750,72F4F7A2,0,1,1,1,0,0,0,0
751,7D9B26F5,0,1,1,1,0,0,0,0
752,7D0BC103,0,1,1,1,0,0,0,0
753,7B4810CD,5,4,9,0.52381,46,0,0,0.050708
754,765140C1,0,1,1,0.388889,0,0,0,0
755,7FE1D4D3,0,1,1,1,0,0,0,0
756,7D33A1FD,4,2,6,0.391304,24.666667,0,0,0.02218
757,7692EA68,1,0,1,0,0,0,0,0.005241
758,60E197E1,1,0,1,0,0,0,0,0.005241
759,80ED9B8B,27,0,27,0,0,0.324931,0,0.428791
760,8097D262,0,2,2,0.625,0,0,0,0
761,78EEC460,1,0,1,0,0,0,0,0.003312
762,80CE4896,1,1,2,1,30,0,0,0.036236
763,7F1F2ACF,2,0,2,0,0,0,0,0.017898
764,7A6A0675,1,0,1,0,0,0,0,0.003312
765,7AF8343F,0,1,1,1,0,0,0,0
766,787BD218,1,0,1,0,0,0,0,0.005241
767,5990D44E,1,0,1,0,0,0,0,0.003312
768,78ACA354,0,6,6,0.8,0,0,0,0
769,7C4E2971,0,1,1,1,0,0,0,0
770,79A72904,1,0,1,0,0,0,0,0.003312
771,59A94585,2,0,2,0,0,0,0,0.006624
772,7ABE01BA,1,0,1,0,0,0,0,0.003312
773,7C42FABA,0,1,1,0.424242,0,0,0.000733,0
774,5FA2E6C3,1,0,1,0,0,0,0,0.003312
775,79564B4B,3,0,3,0,0,0,0,0.011865
776,79B5F781,0,2,2,1,0,0,0,0
777,6F288119,3,0,3,0,0,0,0,0.022525
778,75E974B5,4,3,7,0.434783,55,0,0,0.027045
779,7F44B708,0,1,1,0.5,0,0,0,0
780,80DE4AE5,0,2,2,1,0,0,0,0
781,7FDEAA7A,0,1,1,1,0,0,0,0
782,6EE7A680,3,1,4,1,3,0,0,0.009935
783,815B6DB2,1,0,1,0,0,0,0,0.005241
784,80EB29FB,0,1,1,0.5,0,0,0,0
785,7E2CE179,0,3,3,1,0,0,0,0
786,7A3AD321,1,0,1,0,0,0,0,0.003312
787,7747F9D8,2,0,2,0,0,0,0,0.006624
788,7D448833,2,2,4,0.444444,4.5,0,0,0.006624
789,802DF659,0,1,1,0.666667,0,0,0,0
790,811DC99D,0,2,2,0.5,0,0,0,0
791,7FA20B59,3,2,5,0.75,18.166667,0,0,0.028314
792,59D12073,1,0,1,0,0,0,0,0.003312
793,7A278466,1,5,6,1,5,0,0,0.003312
794,7DE2244D,0,2,2,0.275862,0,0,0,0
795,7CFC1674,0,3,3,1,0,0,0,0
796,7DC46837,2,2,4,0.75,2.5,0,0,0.006624
797,7C18DC40,2,0,2,0,0,0,0,0.008553
798,7D9583F2,4,0,4,0,0,0,0,0.06566
799,764B234F,1,0,1,0,0,0,0,0.003312
800,80223036,1,1,2,0.666667,2,0,0,0.003312
801,7E84FCB4,0,1,1,0.666667,0,0,0,0
802,80E24782,2,5,7,0.857143,43.166667,0,0,0.018214
803,804AA500,1,0,1,0,0,0,0,0.003312
804,031EB094,4,1,5,1,59,0,0,0.109598
805,802251B0,0,5,5,0.403509,0,0,0,0
806,8132265C,4,3,7,0.44,69,0,0,0.02218
807,7EDD1AAF,2,0,2,0,0,0,0,0.006624
808,7BA72C66,0,1,1,1,0,0,0,0
809,7E92FCA8,0,1,1,1,0,0,0,0
810,76EEBC00,1,0,1,0,0,0,0,0.003312
811,7D6AD292,0,5,5,0.388889,0,0,0,0
812,7BFF3563,0,5,5,0.565217,0,0,0,0
813,7DEB0D1D,0,2,2,1,0,0,0,0
814,77B8E911,0,1,1,0.555556,0,0,0,0
815,7A5F34EB,0,1,1,1,0,0,0,0
816,7CE9600A,0,1,1,1,0,0,0,0
817,7B0758BE,0,3,3,0.615385,0,0,0.000015,0
818,7E268BD6,0,1,1,1,0,0,0,0
819,7EA2F1C7,7,0,7,0,0,0,0,0.040283
820,7E4E617B,0,1,1,1,0,0,0,0
821,7DE2B94B,0,1,1,1,0,0,0,0
822,76E8E43C,5,3,8,0.666667,22.333333,0.000005,0.000002,0.020418
823,7BE0EAAC,1,0,1,0,0,0,0,0.003312
824,80ED7746,1,0,1,0,0,0,0,0.003312
825,797A02F2,1,0,1,0,0,0,0,0.003312
826,7CFE4363,0,8,8,0.681818,0,0,0,0
827,7CEDB83F,1,0,1,0,0,0,0,0.003312
828,7CB983A6,1,0,1,0,0,0,0,0.003312
829,807705CF,0,1,1,1,0,0,0,0
830,771EE2C1,0,2,2,0.666667,0,0,0,0
831,78C90853,0,2,2,0.305785,0,0,0,0
832,776E2FBB,0,3,3,1,0,0,0,0
833,790E0DC4,0,1,1,1,0,0,0,0
834,76853E3E,0,2,2,1,0,0,0,0
835,683EBA97,0,1,1,0.421053,0,0,0.000032,0
836,81270E8A,0,7,7,0.479167,0,0,0,0
837,79E3C44A,1,1,2,1,0,0,0,0.003312
838,6F38419A,1,1,2,1,3,0,0,0.00717
839,76F4CE46,0,1,1,0.6,0,0,0,0
840,7E319111,1,0,1,0,0,0,0,0.007118
841,7D903B62,1,0,1,0,0,0,0,0.003312
842,789639DF,0,1,1,0.38,0,0,0,0
843,79C42F8B,9,0,9,0,0,0,0,0.036149
844,78B1BE85,0,1,1,0.666667,0,0,0,0
845,8068000B,0,1,1,1,0,0,0,0
846,7994DDC4,1,0,1,0,0,0,0,0.003312
847,7766D1CE,0,2,2,1,0,0,0,0
848,762A2CAF,1,0,1,0,0,0,0,0.003312
849,7A8DA596,3,0,3,0,0,0,0,0.009935
850,7E3A56B2,0,2,2,0.314286,0,0,0,0
851,7961CF15,0,3,3,0.380952,0,0,0,0
852,8115A151,0,1,1,1,0,0,0,0
853,768C471E,0,2,2,0.5,0,0,0,0
854,7E94A7B7,0,1,1,1,0,0,0,0
855,811321CF,1,1,2,1,1,0,0,0.003312
856,7D36FD8D,0,1,1,0.666667,0,0,0,0
857,78EC6B08,4,0,4,0,0,0,0,0.022736
858,77F070A0,0,4,4,0.636364,0,0,0,0
859,7F3229EE,1,0,1,0,0,0,0,0.003312
860,7F07BAFC,2,5,7,0.405405,31,0,0,0.012412
861,7D11789F,0,1,1,1,0,0,0,0
862,7BE7773A,1,0,1,0,0,0,0,0.005241
863,7FE2E0DB,1,0,1,0,0,0,0,0.013476
864,7F7DC131,0,12,12,0.458824,0,0,0,0
865,7F020A65,1,0,1,0,0,0,0,0.003312
866,77CF6C22,0,2,2,1,0,0,0,0
867,75A8A3C4,0,4,4,1,0,0,0,0
868,7ACC663D,0,1,1,1,0,0,0,0
869,7522FE16,1,0,1,0,0,0,0,0.003312
870,7BA10190,1,0,1,0,0,0,0,0.003312
871,756CC619,1,0,1,0,0,0,0,0.003312
872,7EB28172,0,6,6,0.409836,0,0,0,0
873,7AD3BCCD,1,0,1,0,0,0,0,0.003312
874,7F8265BA,0,2,2,0.5,0,0,0.003032,0
875,7E752871,1,0,1,0,0,0,0,0.003312
876,756577D8,2,6,8,0.4375,40.166667,0,0,0.010482
877,81129DB4,2,0,2,0,0,0,0,0.008553
878,750A8B7F,1,0,1,0,0,0,0,0.00717
879,80B1C857,0,2,2,0.75,0,0,0,0
880,7EAB58AB,0,3,3,1,0,0,0,0
881,7A095ED7,3,0,3,0,0,0,0,0.016279
882,61DDFB49,1,0,1,0,0,0,0,0.003312
883,7E31E3FA,1,0,1,0,0,0,0,0.003312
884,7A2A7CA2,0,1,1,1,0,0,0,0
885,7D80937E,0,1,1,1,0,0,0,0
886,6A4113BC,0,2,2,0.5,0,0,0,0
887,7EE13897,1,2,3,0.625,3,0,0,0.003312
888,769D5635,3,0,3,0,0,0,0,0.020798
889,77D0CA90,0,1,1,1,0,0,0,0
890,7D3FD7A4,0,2,2,1,0,0,0,0
891,7B8CC1C4,3,0,3,0,0,0,0,0.013794
892,68980158,1,0,1,0,0,0,0,0.003312
893,7ACD8A41,1,1,2,1,0,0,0,0.003312
894,79C677EA,1,1,2,1,1,0,0,0.003312
895,7A3737E7,1,1,2,0.410256,16,0,0,0.003312
896,799B8B03,1,1,2,1,1,0,0,0.003312
897,7DF6ECB5,0,4,4,1,0,0,0,0
898,7716297B,6,0,6,0,0,0,0,0.051986
899,7745A52B,1,0,1,0,0,0,0,0.003312
900,8126D18B,2,0,2,0,0,0,0,0.008553
901,78694BC3,1,0,1,0,0,0,0,0.003312
902,7F5CE46D,0,1,1,0.444444,0,0,0,0
903,76F3AA83,2,0,2,0,0,0,0,0.008553
904,771E747A,0,4,4,0.394495,0,0,0,0
905,7D58AC26,0,1,1,0.5,0,0,0,0
906,7F2FCDF3,1,0,1,0,0,0,0,0.003312
907,79F6C688,1,0,1,0,0,0,0,0.003312
908,76F2987E,1,0,1,0,0,0,0,0.011585
909,7CD90314,1,0,1,0,0,0,0,0.003312
910,7CB496AF,1,1,2,1,1,0,0,0.003312
911,7FC754D0,1,0,1,0,0,0,0,0.005241
912,7656DBC6,2,0,2,0,0,0,0,0.008553
913,76D02FEC,1,0,1,0,0,0,0,0.003312
914,761C9389,2,0,2,0,0,0,0,0.008553
915,7D3E4AA9,0,1,1,1,0,0,0,0
916,7DD31005,2,0,2,0,0,0,0,0.010482
917,7571D7AA,2,3,5,1,4,0,0,0.006624
918,6888633C,1,0,1,0,0,0,0,0.003312
919,79B0F888,1,0,1,0,0,0,0,0.003312
920,59B27533,0,1,1,0.388889,0,0,0,0
921,801090FA,0,1,1,1,0,0,0,0
922,7EFE8480,1,0,1,0,0,0,0,0.005796
923,7A5C90A6,2,0,2,0,0,0,0,0.010482
924,7EF0A84F,3,2,5,1,2.5,0,0,0.009935
925,7C0AA848,1,0,1,0,0,0,0,0.003312
926,801A4288,0,1,1,1,0,0,0,0
927,7540912B,5,0,5,0,0,0,0,0.032343
928,80D71102,4,1,5,1,3.5,0,0,0.030348
929,810D1843,0,1,1,0.4,0,0,0,0
930,7D01A6C6,1,2,3,0.370968,0,0,0,0.00717
931,78F27000,0,1,1,1,0,0,0,0
932,76E95770,1,0,1,0,0,0,0,0.003312
933,7E4135D3,0,2,2,0.75,0,0,0,0
934,79E737C8,1,0,1,0,0,0,0,0.003312
935,7703B2DE,1,1,2,0.466667,7,0,0,0.003312
936,812513C1,1,3,4,0.4375,7,0,0,0.003312
937,75661329,0,1,1,1,0,0,0,0
938,7947954A,0,1,1,1,0,0,0,0
939,7B1A272F,2,0,2,0,0,0,0,0.008553
940,80682684,0,1,1,1,0,0,0,0
941,7E9548D1,0,2,2,1,0,0,0,0
942,7AA001D1,1,0,1,0,0,0,0,0.005241
943,808F5AEE,0,1,1,0.5,0,0,0,0
944,7D41623D,2,3,5,0.8,2,0,0,0.006624
945,0E0AA79C,0,2,2,0.75,0,0,0,0
946,7DB2FE4A,0,1,1,1,0,0,0,0
947,7FCF2D9A,10,2,12,0.5,109.166667,0,0,0.095564
948,5C24E798,1,0,1,0,0,0,0,0.031965
949,7CB538D7,1,0,1,0,0,0,0,0.003312
950,7DFBAB3A,2,4,6,0.483871,35.5,0,0,0.011038
951,7B6B8CBD,3,0,3,0,0,0,0,0.017653
952,7BC73C6B,4,4,8,0.52381,40,0,0,0.015176
953,785C90B1,1,0,1,0,0,0,0,0.017215
954,7D780A76,0,1,1,1,0,0,0,0
955,7E9FEAA5,0,2,2,1,0,0,0,0
956,7FCE3688,1,0,1,0,0,0,0,0.003312
957,7CD3CA1E,1,0,1,0,0,0,0,0.003312
958,814BE49C,0,2,2,1,0,0,0,0
959,816B53D3,0,5,5,0.414634,0,0,0,0
960,7FBC544A,2,7,9,0.423077,5.166667,0,0,0.006624
961,7D698905,1,0,1,0,0,0,0,0.003312
962,80753077,6,2,8,0.347826,12.333333,0,0,0.096234
963,773CA8EF,1,0,1,0,0,0,0,0.003312
964,7B3C72B6,1,0,1,0,0,0,0,0.003312
965,7AEC9AA4,0,2,2,0.75,0,0,0,0
966,7E046738,1,0,1,0,0,0,0,0.003312
967,7EC08350,0,2,2,0.5,0,0,0,0
968,7BCE17F7,0,2,2,0.331361,0,0,0,0
969,7A693203,1,0,1,0,0,0,0,0.003312
970,7D3C2CAC,4,4,8,0.666667,28,0.000041,0.000001,0.015176
971,64335901,3,0,3,0,0,0,0,0.020137
972,80656AC1,3,2,5,1,5,0,0,0.011865
973,7C5C1A89,0,2,2,1,0,0,0,0
974,7B472185,2,2,4,0.5,8,0,0,0.008553
975,7F1FFF31,0,2,2,0.416667,0,0,0,0
976,7DDD9EC7,0,2,2,1,0,0,0,0
977,805ECD3F,1,3,4,0.5,1,0,0,0.003312
978,8142A460,0,2,2,1,0,0,0,0
979,76A6DBEA,2,3,5,0.526316,8.866667,0,0,0.02145
980,7C9D0820,1,0,1,0,0,0,0,0.003312
981,810DECC7,0,2,2,0.392157,0,0,0,0
982,7CBF10EA,3,1,4,1,3,0,0,0.009935
983,7EC65049,0,3,3,0.313043,0,0,0,0
984,7DC89677,1,3,4,1,1.5,0,0,0.003312
985,7A293D9E,1,0,1,0,0,0,0,0.003312
986,7F83D54A,0,1,1,1,0,0,0,0
987,7E668212,2,12,14,0.535211,64.033333,0,0,0.009108
988,7BC230F3,1,0,1,0,0,0,0,0.00717
989,7C3658E0,0,1,1,0.375,0,0,0,0
990,79D87E42,1,0,1,0,0,0,0,0.003312
991,7AABFBD0,1,0,1,0,0,0,0,0.005241
992,7DA3C4DD,2,2,4,1,8,0,0,0.012412
993,80C6A2E4,1,2,3,0.236559,22,0,0,0.003312
994,7FB9ED58,1,2,3,1,0,0,0,0.005241
995,7EC00AE1,0,1,1,1,0,0,0,0
996,7839EFC0,5,0,5,0,0,0,0,0.016559
997,81C89D98,1,0,1,0,0,0,0,0.003312
998,7C0AEB04,0,1,1,1,0,0,0,0
999,7D4DE8E6,0,1,1,1,0,0,0,0
1000,7A4FB0FB,0,4,4,0.447368,0,0,0.000001,0
1001,7D83CF47,3,1,4,1,0.5,0,0,0.015723
1002,72828786,2,0,2,0,0,0,0,0.012412
1003,79049A1D,6,0,6,0,0,0,0,0.088905
1004,751D8E02,0,1,1,0.666667,0,0,0,0
1005,812EF016,0,3,3,1,0,0,0,0
1006,7677799D,2,1,3,1,3,0,0,0.008553
1007,7D59CF53,0,1,1,1,0,0,0,0
1008,769EA186,0,3,3,0.588235,0,0,0,0
1009,5FC6CB31,0,1,1,1,0,0,0,0
1010,7568ACDB,1,0,1,0,0,0,0,0.00717
1011,8006DCC4,0,2,2,1,0,0,0,0
1012,7869FBAB,2,2,4,0.666667,12,0,0,0.011038
1013,14E16DFD,2,0,2,0,0,0,0,0.041531
1014,75F31EDD,0,1,1,1,0,0,0,0
1015,07B6ED1E,1,1,2,0.5,0,0,0,0.005241
1016,78DE9DAD,0,3,3,0.45,0,0,0,0
1017,7F17CA21,0,11,11,0.507463,0,0,0,0
1018,7A2CFBFB,9,0,9,0,0,0,0,0.033665
1019,805B769B,0,2,2,0.571429,0,0,0,0
1020,783A1EDE,1,0,1,0,0,0,0,0.005241
1021,019679A8,1,0,1,0,0,0,0,0.109211
1022,768DAEF6,7,1,8,0.375,19.333333,0,0,0.056475
1023,8045796D,0,1,1,1,0,0,0,0
1024,7E35C3E1,2,1,3,1,14,0,0,0.013576
1025,7C25D5B7,1,0,1,0,0,0,0,0.005241
1026,780D7C25,0,2,2,0.441176,0,0,0.000741,0
1027,762ADF70,1,0,1,0,0,0,0,0.003312
1028,7ACE0271,0,1,1,1,0,0,0.000002,0
1029,7E12FD7A,1,0,1,0,0,0,0,0.00717
1030,7F624470,0,1,1,1,0,0,0,0
1031,816960D8,0,2,2,0.555556,0,0,0,0
1032,7CEC64DF,0,1,1,0.6,0,0,0,0
1033,7E2250C5,0,1,1,1,0,0,0,0
1034,7BD69403,0,3,3,1,0,0,0,0
1035,60071F70,1,0,1,0,0,0,0,0.003312
1036,7C7F60D9,1,1,2,1,1,0,0,0.003312
1037,7751762B,1,1,2,1,1,0,0,0.003312
1038,7F941A92,0,2,2,1,0,0,0,0
1039,7DC55818,1,0,1,0,0,0,0,0.003312
1040,78950E7F,1,0,1,0,0,0,0,0.003312
1041,7F73B179,0,1,1,1,0,0,0,0
1042,760B663C,1,0,1,0,0,0,0,0.003312
1043,7E302396,0,1,1,1,0,0,0,0
1044,71B1B1A1,4,0,4,0,0,0,0,0.017661
1045,7F3CFFFD,0,1,1,0.666667,0,0,0,0
1046,773038E5,1,2,3,1,1,0,0,0.003312
1047,7DD0F175,0,2,2,0.333333,0,0,0,0
1048,7BC377D1,1,0,1,0,0,0,0,0.005241
1049,7AF6A5CD,0,4,4,1,0,0,0,0
1050,7EDC7BB2,0,2,2,0.5,0,0,0,0
1051,7C01D0CF,0,1,1,1,0,0,0,0
1052,5EA2A844,0,1,1,1,0,0,0,0
1053,75116719,1,0,1,0,0,0,0,0.003312
1054,7EDA8E37,0,1,1,1,0,0,0,0
1055,7F18300D,0,5,5,0.6,0,0,0,0
1056,810ED534,1,0,1,0,0,0,0,0.011585
1057,804CEF65,4,2,6,0.571429,6.5,0,0,0.015176
1058,75C489C6,0,1,1,1,0,0,0,0
1059,7A7A58DB,0,3,3,1,0,0,0,0
1060,7D17A127,0,2,2,0.5,0,0,0,0
1061,8132A67A,6,6,12,1,60,0,0,0.028143
1062,75CAC7B4,1,0,1,0,0,0,0,0.003312
1063,814A10FD,3,0,3,0,0,0,0,0.041286
1064,80B1AC70,2,0,2,0,0,0,0,0.006624
1065,78D9C8F7,1,0,1,0,0,0,0,0.003312
1066,775D59BA,1,0,1,0,0,0,0,0.003312
1067,759DF47E,1,0,1,0,0,0,0,0.003312
1068,7D70DDD9,6,2,8,1,107.913492,0,0,0.146098
1069,7BEF659D,3,0,3,0,0,0,0,0.011865
1070,7E228D35,1,0,1,0,0,0,0,0.003312
1071,80F70C36,1,11,12,0.368664,22.866667,0,0,0.003312
1072,7E161229,0,2,2,1,0,0,0,0
1073,7B580BAE,6,0,6,0,0,0,0,0.029061
1074,7E6F58ED,3,1,4,1,8,0,0,0.01546
1075,790A2026,0,1,1,1,0,0,0,0
1076,7F9FAA48,0,1,1,1,0,0,0,0
1077,7CD9F851,1,0,1,0,0,0,0,0.003312
1078,7DB5F882,3,1,4,1,7.5,0,0,0.023403
1079,795BD276,0,1,1,1,0,0,0,0
1080,75C7763A,1,0,1,0,0,0,0,0.003312
1081,81E880E3,1,0,1,0,0,0,0,0.005241
1082,7B81E5A7,1,0,1,0,0,0,0,0.003312
1083,8111884F,3,9,12,1,33.5,0,0,0.016279
1084,7C2DECC6,0,3,3,0.442308,0,0,0,0
1085,7E7D10A3,1,0,1,0,0,0,0,0.003312
1086,7A00FD16,0,1,1,1,0,0,0,0
1087,773FE3AB,1,0,1,0,0,0,0,0.005241
1088,75D80A0C,2,3,5,0.714286,5,0,0,0.014896
1089,2222CBD6,0,3,3,0.5625,0,0,0.067139,0
1090,799A2EFA,0,1,1,0.666667,0,0,0,0
1091,80F9DD0B,1,0,1,0,0,0,0,0.003312
1092,7FBE2F07,8,4,12,0.833333,33,0,0,0.032282
1093,75F8EBF0,0,4,4,0.833333,0,0,0,0
1094,8141A622,0,1,1,1,0,0,0,0
1095,76AA0BF2,0,5,5,0.857143,0,0,0,0
1096,7BFC8CD6,1,1,2,1,1,0,0,0.003312
1097,7F0F0848,3,0,3,0,0,0,0,0.115001
1098,78B9AB01,7,0,7,0,0,0,0,0.023182
1099,762E123C,2,4,6,0.6,1.5,0.030161,0.127279,0.008553
1100,5BD9F051,1,0,1,0,0,0,0,0.003312
1101,7AD98264,1,0,1,0,0,0,0,0.00717
1102,76A984A1,2,4,6,0.380952,33.666667,0,0,0.006624
1103,75FE339B,1,1,2,0.366972,0,0,0,0.003312
1104,7FE970D3,1,0,1,0,0,0,0,0.003312
1105,7D238DEC,7,0,7,0,0,0,0,0.028707
1106,805995C1,1,0,1,0,0,0,0,0.013679
1107,77B997E1,0,1,1,0.375,0,0,0,0
1108,7ACEC295,0,2,2,0.583333,0,0,0.058765,0
1109,79D5B97A,1,2,3,1,1,0,0,0.003312
1110,7670B088,2,0,2,0,0,0,0,0.014896
1111,7BBD59A1,0,1,1,1,0,0,0,0
1112,7E3A5B17,3,1,4,1,2,0,0,0.009935
1113,63A40A05,3,0,3,0,0,0,0,0.011865
1114,7621C312,0,3,3,0.8,0,0,0,0
1115,779666B3,2,2,4,1,4,0,0,0.010482
1116,78326B04,0,2,2,0.346154,0,0,0,0
1117,5BCB6850,32,0,32,0,0,0.452977,0,0.437896
1118,61A025F7,0,1,1,0.666667,0,0,0,0
1119,809AB561,2,7,9,0.5,11.166667,0,0,0.006624
1120,7ACC87EE,2,0,2,0,0,0,0,0.025946
1121,7C35A0EC,0,2,2,0.666667,0,0,0,0
1122,81789E08,1,2,3,1,2,0,0,0.003312
1123,7A12D5B7,1,0,1,0,0,0,0,0.005241
1124,7C0B34F9,1,0,1,0,0,0,0,0.003312
1125,807E7C2C,0,1,1,1,0,0,0,0
1126,76603CE8,1,2,3,1,4,0,0,0.005241
1127,751A2A4D,1,0,1,0,0,0,0,0.003312
1128,8095E13B,6,2,8,0.666667,66.333333,0,0,0.031499
1129,804D3C93,0,1,1,1,0,0,0,0
1130,7C086605,0,1,1,1,0,0,0,0
1131,78DD0A84,0,1,1,0.5,0,0,0,0
1132,75D459B1,2,0,2,0,0,0,0,0.020129
1133,59D0380D,2,3,5,0.434783,14.833333,0,0,0.008553
1134,7E90855A,0,1,1,0.5,0,0,0,0
1135,7E7941FB,0,1,1,1,0,0,0,0
1136,7A148939,0,1,1,1,0,0,0,0
1137,7FC48201,2,0,2,0,0,0,0,0.006624
1138,7F85808F,4,0,4,0,0,0,0,0.079575
1139,795EA6A8,1,0,1,0,0,0.003421,0,0.005241
1140,77F7276B,0,1,1,1,0,0,0,0
1141,7B58F078,0,1,1,1,0,0,0,0
1142,7F053A3C,0,1,1,0.461538,0,0,0,0
1143,7FE184F9,3,0,3,0,0,0,0,0.014349
1144,7660A103,1,0,1,0,0,0,0,0.003312
1145,7D6B5894,1,3,4,0.8,4,0,0,0.003312
1146,7D01A32E,2,0,2,0,0,0,0,0.008553
1147,8124409E,0,2,2,0.666667,0,0,0,0
1148,7FF2E97B,0,1,1,0.36,0,0,0,0
1149,78A36142,0,1,1,1,0,0,0,0
1150,7E7A7436,3,0,3,0,0,0,0,0.011865
1151,7D68D479,1,0,1,0,0,0,0,0.003312
1152,7D079560,1,0,1,0,0,0,0,0.003312
1153,7B9FCA57,5,1,6,0.666667,10,0,0,0.022347
1154,76333D50,0,2,2,0.75,0,0,0,0
1155,7D56B4CC,0,1,1,0.322034,0,0,0,0
1156,7E408528,0,2,2,0.394737,0,0,0,0
1157,76DDA63E,2,0,2,0,0,0,0,0.008553
1158,8047AC28,2,2,4,0.666667,12.5,0,0,0.010482
1159,7E7C3EBB,3,1,4,0.666667,0,0,0,0.013741
1160,77C7F816,0,1,1,1,0,0,0,0
1161,798A9746,7,0,7,0,0,0,0,0.092085
1162,75F27A40,0,1,1,1,0,0,0,0
1163,78F3C6EA,0,1,1,1,0,0,0,0
1164,758DFF5E,0,1,1,1,0,0,0,0
1165,77106279,1,0,1,0,0,0,0,0.003312
1166,7D9276DE,0,4,4,0.615385,0,0,0,0
1167,8035C68B,0,4,4,1,0,0,0,0
1168,756FEF70,2,2,4,1,6,0,0,0.008553
1169,5BAB4207,1,0,1,0,0,0,0,0.003312
1170,7C4D2537,0,2,2,1,0,0,0,0
1171,7F6610E3,1,0,1,0,0,0,0,0.003312
1172,7AC299E4,1,0,1,0,0,0,0,0.003312
1173,7D45B30E,2,0,2,0,0,0,0,0.008553
1174,77A6F251,3,0,3,0,0,0,0,0.023177
1175,7E11CD4E,0,2,2,0.5,0,0,0.034619,0
1176,7CE0D721,0,3,3,1,0,0,0,0
1177,81280F97,2,6,8,0.396825,41,0,0,0.006624
1178,7E8255B4,0,2,2,1,0,0,0,0
1179,80DEA0C3,2,0,2,0,0,0.000005,0,0.008553
1180,7E091FE6,0,1,1,1,0,0,0,0
1181,7F158A9A,5,2,7,1,20,0,0,0.023563
1182,8136741E,0,1,1,0.391304,0,0,0,0
1183,5DEAFFD9,1,0,1,0,0,0,0,0.003312
1184,7CF57C0D,2,0,2,0,0,0,0,0.006624
1185,77BF1E7F,1,2,3,0.75,3,0,0,0.003312
1186,7D7955B4,0,6,6,0.692308,0,0,0,0
1187,7BAB8E3A,0,1,1,1,0,0,0,0
1188,7BB93ED8,2,0,2,0,0,0,0,0.008553
1189,79196362,0,2,2,1,0,0,0,0
1190,7FE452F7,1,0,1,0,0,0,0,0.003312
1191,7E31F511,2,1,3,0.666667,1,0,0,0.011593
1192,782B0AAA,0,1,1,1,0,0,0,0
1193,7B21EE53,1,0,1,0,0,0,0,0.003312
1194,80EEFF15,0,1,1,0.368421,0,0,0,0
1195,80786C31,2,1,3,1,2,0,0,0.008553
1196,8062FC40,0,1,1,1,0,0,0,0
1197,7ACD8E6E,2,0,2,0,0,0,0,0.006624
1198,7CFB39F7,0,4,4,0.55,0,0,0,0
1199,62D48A29,1,0,1,0,0,0,0,0.005241
1200,75DDA810,0,3,3,0.6,0,0,0,0
1201,753FF319,2,1,3,1,1,0,0,0.011038
1202,795378A7,1,0,1,0,0,0,0,0.008281
1203,8082C94C,0,2,2,0.416667,0,0,0,0
1204,7A41900D,0,1,1,1,0,0,0,0
1205,7B4B1A13,1,0,1,0,0,0,0,0.003312
1206,77E940DD,1,1,2,1,1,0,0,0.003312
1207,7BDAB45B,10,0,10,0,0,0,0,0.126021
1208,7D5A8550,0,1,1,0.3,0,0,0,0
1209,7DB8FBFC,0,1,1,1,0,0,0,0
1210,7AB87270,0,2,2,0.461538,0,0,0,0
1211,756358B9,3,1,4,0.5,12,0,0,0.011865
1212,6BFB28B6,0,4,4,0.512821,0,0,0.001123,0
1213,7BCBCBA0,0,2,2,0.75,0,0,0,0
1214,7A338D72,0,1,1,0.529412,0,0,0,0
1215,8140ACC3,1,0,1,0,0,0,0,0.003312
1216,80D0D855,1,0,1,0,0,0,0,0.003312
1217,7E17A495,1,1,2,1,1,0,0,0.003312
1218,5DC10F2B,1,0,1,0,0,0,0,0.003312
1219,7B48AE39,2,1,3,1,1,0,0,0.008553
1220,7BAAA1CF,0,4,4,0.427586,0,0,0,0
1221,7A0B518D,1,0,1,0,0,0,0,0.003312
1222,6D4AC13A,0,3,3,0.8,0,0,0,0
1223,78F041CD,1,0,1,0,0,0,0,0.003312
1224,8015829F,0,1,1,1,0,0,0,0
1225,793B829C,1,1,2,0.666667,0,0,0,0.003312
1226,7795CC77,0,2,2,1,0,0,0,0
1227,7A94A69F,0,2,2,1,0,0,0,0
1228,811A1252,0,2,2,0.4,0,0,0,0
1229,76D65532,0,2,2,1,0,0,0,0
1230,8088A43A,1,6,7,1,6,0,0,0.003312
1231,7FAB626C,0,2,2,1,0,0,0,0
1232,806EC83B,0,2,2,1,0,0,0,0
1233,801B6D1D,2,0,2,0,0,0,0,0.010482
1234,5ED11C8E,0,5,5,0.578947,0,0,0,0
1235,7827BDB0,1,0,1,0,0,0,0,0.010871
1236,804A5D2F,6,1,7,1,4.666667,0,0,0.033879
1237,7D0D2801,1,0,1,0,0,0,0,0.003312
1238,76EC73F7,1,0,1,0,0,0,0,0.005241
1239,7695CDE2,0,1,1,1,0,0,0,0
1240,7C7BAE0F,1,1,2,1,2,0.000002,0,0.005241
1241,7B9D625A,0,1,1,1,0,0,0,0
1242,7753D156,1,2,3,1,2,0,0,0.003312
1243,7A335C17,1,0,1,0,0,0,0,0.003312
1244,8071B9C3,1,2,3,0.4375,2.5,0,0,0.003312
1245,79971D15,0,1,1,0.375,0,0,0,0
1246,7CA15535,1,0,1,0,0,0,0,0.003312
1247,7DBC091E,4,3,7,0.8,6,0,0,0.019035
1248,75F0284E,3,0,3,0,0,0,0,0.014349
1249,7FA223EB,0,1,1,1,0,0,0,0
1250,7CD2EC2B,1,0,1,0,0,0,0,0.003312
1251,5EBD3153,0,3,3,1,0,0,0,0
1252,7D8439F6,2,0,2,0,0,0,0,0.006624
1253,7AEDFF3D,1,0,1,0,0,0,0,0.003312
1254,784660B8,1,1,2,1,1,0,0,0.003312
1255,7790C120,0,1,1,1,0,0,0,0
1256,81C93A45,2,2,4,0.478261,22,0,0,0.006624
1257,7C5F2DDC,1,0,1,0,0,0,0,0.008281
1258,7910756A,0,1,1,0.4,0,0,0,0
1259,76E70462,0,1,1,0.375,0,0,0,0
1260,7B6C596B,0,1,1,1,0,0,0,0
1261,7909AE4B,2,0,2,0,0,0,0,0.008553
1262,7BD85617,1,1,2,1,1,0,0,0.003312
1263,76036D9B,2,0,2,0,0,0,0,0.015069
1264,7C0EC6EF,0,1,1,1,0,0,0,0
1265,7570D126,0,1,1,1,0,0,0,0
1266,7F93B9DD,1,0,1,0,0,0,0,0.003312
1267,7B5546E2,0,1,1,1,0,0,0,0
1268,8019D0CF,1,1,2,1,3,0,0,0.00717
1269,7BB58374,0,1,1,0.6,0,0,0,0
1270,78EF61D0,0,1,1,1,0,0,0,0
1271,7EDBEF21,2,2,4,0.411765,13.083333,0,0,0.010482
1272,806604F0,0,1,1,0.571429,0,0,0,0
1273,770F509C,0,1,1,1,0,0,0,0
1274,7E1B9A2A,0,1,1,0.666667,0,0,0,0
1275,7784A9AF,1,1,2,0.6,0,0,0,0.003312
1276,7E23B7B9,4,2,6,0.384615,98,0,0,0.015176
1277,752D54A3,0,2,2,1,0,0,0,0
1278,8070BB20,0,1,1,1,0,0,0,0
1279,7CAD7712,2,0,2,0,0,0,0,0.011038
1280,7B2925FC,0,3,3,0.384615,0,0,0,0
1281,7ACAB5C9,1,1,2,0.410256,61.333333,0,0,0.027335
1282,7DCF1117,1,4,5,0.642857,8,0,0.000024,0.003312
1283,7D526A60,2,3,5,0.45,32,0,0,0.006624
1284,7A935AEF,0,4,4,0.75,0,0,0,0
1285,8021B8C4,0,1,1,0.416667,0,0,0,0
1286,79AA271E,3,0,3,0,0,0,0,0.016279
1287,7BB63BDB,2,0,2,0,0,0,0,0.006624
1288,76483665,4,1,5,1,4,0,0,0.020964
1289,75D6E849,3,1,4,0.5,9,0,0,0.009935
1290,7F9F60CB,0,5,5,0.487179,0,0,0,0
1291,7CD6F2A6,1,0,1,0,0,0,0,0.005241
1292,81130672,0,3,3,0.5,0,0,0,0
1293,6C250973,1,0,1,0,0,0,0,0.003312
1294,7B6C3E87,3,1,4,1,2,0,0,0.009935
1295,7770F12F,1,0,1,0,0,0,0,0.003312
1296,7725BBFD,1,0,1,0,0,0,0,0.003312
1297,7F3F717C,3,0,3,0,0,0,0,0.009935
1298,7D0C3801,1,1,2,1,1,0,0,0.005241
1299,7C11C0C7,2,0,2,0,0,0,0,0.006624
1300,756DDFF6,0,4,4,0.666667,0,0,0,0
1301,80354C94,3,2,5,1,48.833333,0,0,0.041782
1302,7B7A5626,0,1,1,0.375,0,0,0,0
1303,7E66984B,1,0,1,0,0,0,0,0.003312
1304,80E77F5C,0,3,3,1,0,0,0,0
1305,80E93432,0,1,1,1,0,0,0,0
1306,7AD4F067,1,0,1,0,0,0,0,0.003312
1307,774667E3,2,3,5,1,9,0,0,0.008553
1308,8156AF37,0,1,1,1,0,0,0,0
1309,7FCBA943,0,4,4,0.352113,0,0,0,0
1310,78401A99,3,0,3,0,0,0,0,0.018208
1311,80F54B63,4,0,4,0,0,0,0,0.048101
1312,7F7FC32B,1,0,1,0,0,0,0,0.003312
1313,7D5A68DF,4,1,5,1,4,0,0,0.015176
1314,5E1EB61C,0,1,1,0.666667,0,0,0,0
1315,7BEEE644,0,2,2,1,0,0,0,0
1316,75627239,1,0,1,0,0,0,0,0.003312
1317,769B45E8,3,0,3,0,0,0,0,0.017495
1318,7ADE0CA4,3,0,3,0,0,0,0,0.021473
1319,7971BE8E,1,0,1,0,0,0,0,0.003312
1320,80E701C1,1,0,1,0,0,0,0,0.003312
1321,81FC3214,1,0,1,0,0,0,0,0.003312
1322,8118C2CA,0,1,1,0.666667,0,0,0,0
1323,8376E3DF,1,0,1,0,0,0,0,0.003312
1324,7A28325E,1,0,1,0,0,0,0,0.003312
1325,7523B771,0,3,3,0.305085,0,0,0,0
1326,80006792,4,0,4,0,0,0,0,0.013247
1327,800FE75F,0,1,1,1,0,0,0,0
1328,7653E68E,0,1,1,0.666667,0,0,0,0
1329,7C92341D,1,0,1,0,0,0,0,0.003312
1330,7CF28460,0,1,1,1,0,0,0,0
1331,8045AF11,0,1,1,1,0,0,0,0
1332,7F4CBA1E,0,3,3,1,0,0,0,0
1333,7A5B67B0,0,1,1,1,0,0,0,0
1334,7518735E,2,0,2,0,0,0,0,0.006624
1335,7F2A6F79,0,1,1,1,0,0,0,0
1336,7C3D0A21,0,2,2,0.538462,0,0,0,0
1337,7A745CF8,0,2,2,0.297297,0,0,0,0
1338,7DB6F713,0,2,2,0.75,0,0,0,0
1339,850620CF,1,0,1,0,0,0,0,0.003312
1340,77EFFC58,1,0,1,0,0,0,0,0.003312
1341,810B906C,0,1,1,0.5,0,0,0,0
1342,60BF0ACD,1,0,1,0,0,0,0,0.003312
1343,7EA7F8EF,0,1,1,1,0,0,0,0
1344,7C38B094,17,1,18,1,24,0,0,0.129401
1345,7CBD79C1,1,0,1,0,0,0,0,0.003312
1346,75C26602,1,0,1,0,0,0,0,0.003312
1347,8159E712,1,6,7,1,6,0,0,0.003312
1348,7C057CB8,1,0,1,0,0,0,0,0.003312
1349,7B30D496,1,0,1,0,0,0,0,0.003312
1350,76A1FD63,0,1,1,1,0,0,0,0
1351,7EE3DEB1,0,1,1,0.318182,0,0,0,0
1352,63C0EFE0,0,1,1,1,0,0,0,0
1353,7FE1D06B,0,1,1,0.666667,0,0,0,0
1354,802BD349,0,3,3,1,0,0,0,0
1355,7E26A09A,0,2,2,1,0,0,0,0
1356,77EE33C5,0,1,1,0.5,0,0,0,0
1357,75AA5E4B,7,0,7,0,0,0,0,0.033384
1358,8092D8AA,2,3,5,0.8,6,0,0,0.006624
1359,77853D85,0,3,3,0.433333,0,0,0,0
1360,7A638E29,1,1,2,1,0,0,0,0.003312
1361,79528010,1,0,1,0,0,0,0,0.00717
1362,7ECCD8B7,1,1,2,1,0,0,0,0.003312
1363,7DD90058,0,2,2,1,0,0,0,0
1364,7C8DC4F1,1,7,8,0.444444,26,0,0,0.003312
1365,77F8C517,1,0,1,0,0,0,0,0.003312
1366,7E3F8D6D,1,0,1,0,0,0,0,0.003312
1367,8108577C,0,2,2,0.342105,0,0,0,0
1368,7FCD4963,0,1,1,0.454545,0,0,0,0
1369,7C7AA995,1,2,3,1,2,0,0,0.003312
1370,614980CD,1,0,1,0,0,0,0,0.003312
1371,7FEB6B9A,1,1,2,1,4,0,0,0.009655
1372,8121B287,0,1,1,1,0,0,0,0
1373,80CB1CB5,1,5,6,0.857143,4.5,0,0.000001,0.003312
1374,754A1E02,3,2,5,1,5,0,0,0.011865
1375,7FB600D5,0,1,1,1,0,0,0,0
1376,7B9216DD,4,0,4,0,0,0,0,0.02781
1377,7A6C3F43,0,4,4,0.833333,0,0,0,0
1378,78A2C59A,1,0,1,0,0,0,0,0.003312
1379,46065FFF,0,2,2,0.75,0,0,0.000004,0
1380,816538F1,0,3,3,0.8,0,0,0,0
1381,7EA01244,0,7,7,0.540541,0,0,0.000039,0
1382,7EBAA55A,1,0,1,0,0,0,0,0.003312
1383,78B557AD,7,14,21,0.76,100.516667,0.068126,0.258654,0.029526
1384,784F5186,2,2,4,0.75,6,0,0,0.006624
1385,7ADDCB9D,2,1,3,1,1,0,0,0.006624
1386,757CCB4F,2,0,2,0,0,0,0,0.010482
1387,77DB4F57,0,2,2,0.571429,0,0,0,0
1388,751A7F58,1,11,12,0.75,7.866667,0.016083,0.279038,0.005241
1389,807F4002,1,0,1,0,0,0,0,0.003312
1390,7AFABDAF,0,1,1,0.473684,0,0,0.017276,0
1391,784A92BB,2,1,3,1,1,0,0,0.006624
1392,7E9259AD,1,2,3,0.75,0,0,0,0.003312
1393,7568CA6A,1,0,1,0,0,0,0,0.009655
1394,7FEC5A4D,1,2,3,1,2,0,0,0.005241
1395,7E7571F7,0,1,1,1,0,0,0,0
1396,7F3E6173,2,11,13,0.823529,31.666667,0,0,0.010482
1397,7FDBDEA2,0,1,1,1,0,0,0,0
1398,083C1829,1,0,1,0,0,0,0,0.003312
1399,79E82AD9,1,0,1,0,0,0,0,0.003312
1400,7F1ECFA6,0,2,2,1,0,0,0,0
1401,76B22396,1,0,1,0,0,0,0,0.009655
1402,5AA176AD,5,0,5,0,0,0,0,0.028135
1403,7C330B89,0,1,1,1,0,0,0,0
1404,77FD8A56,2,3,5,0.5,7.083333,0,0,0.025946
1405,7555BBDF,0,1,1,1,0,0,0,0
1406,76B4FF5B,0,2,2,0.75,0,0,0,0
1407,7DC12535,4,5,9,0.517241,22.7,0,0,0.047396
1408,7755F67B,1,0,1,0,0,0,0,0.003312
1409,80C0B72C,1,0,1,0,0,0,0,0.005241
1410,78B6E552,1,0,1,0,0,0,0,0.003312
1411,8116AD8D,1,5,6,1,3,0,0,0.003312
1412,7811E0F3,1,0,1,0,0,0,0,0.003312
1413,7D63E7D6,0,1,1,1,0,0,0,0
1414,7F3945CB,0,1,1,1,0,0,0,0
1415,7858538B,0,2,2,1,0,0,0,0
1416,7A204433,5,0,5,0,0,0,0,0.027316
1417,7814C4DA,2,0,2,0,0,0,0,0.006624
1418,7B4AF5CB,2,0,2,0,0,0,0,0.008553
1419,80969F7B,1,0,1,0,0,0,0,0.003312
1420,754DFBB2,0,1,1,1,0,0,0,0
1421,0A8B32A1,2,0,2,0,0,0,0,0.006624
1422,8033457C,0,4,4,0.7,0,0,0,0
1423,77EDBEB0,0,2,2,1,0,0,0.028006,0
1424,7FF7B42D,1,1,2,1,0,0,0,0.007726
1425,7845327E,1,4,5,0.328767,24,0,0,0.003312
1426,7FED2121,0,1,1,1,0,0,0,0
1427,78EF33CB,1,0,1,0,0,0,0,0.007726
1428,754D2071,8,0,8,0,0,0,0,0.094912
1429,80D53DCC,0,1,1,0.666667,0,0,0,0
1430,7CDAFF83,1,0,1,0,0,0,0,0.003312
1431,7F6ABBC0,0,3,3,1,0,0,0,0
1432,7E216A90,0,4,4,0.636364,0,0,0,0
1433,5B7436F6,1,0,1,0,0,0,0,0.003312
1434,799A5B7B,4,0,4,0,0,0,0,0.017106
1435,7F81C5A8,0,2,2,0.367925,0,0,0,0
1436,7E3D5AE1,0,2,2,1,0,0,0.001532,0
1437,78BE83F5,2,1,3,0.6,6,0,0,0.006624
1438,5D2C8AF6,0,1,1,1,0,0,0,0
1439,77F7443A,3,2,5,0.75,7,0,0,0.009935
1440,816F28E9,0,3,3,0.482759,0,0,0.000005,0
1441,80E3AA26,0,2,2,0.366667,0,0,0,0
1442,7A58A4F3,1,5,6,0.727273,7,0,0,0.003312
1443,7C73DC24,0,1,1,1,0,0,0,0
1444,77178182,3,0,3,0,0,0,0,0.016279
1445,63810C13,3,2,5,1,6.5,0,0,0.014349
1446,7DA9FCF6,0,2,2,0.6,0,0,0,0
1447,5AAB1E57,0,2,2,0.5,0,0,0,0
1448,77475792,0,1,1,1,0,0,0,0
1449,801C0B83,1,7,8,0.45,11.083333,0,0,0.003312
1450,7FDDB443,0,1,1,0.6,0,0,0,0
1451,79BAB079,0,1,1,1,0,0,0,0
1452,759A7186,2,3,5,1,9,0,0,0.008553
1453,7AB4B8AD,1,0,1,0,0,0,0,0.003312
1454,7C1FBDE2,0,1,1,1,0,0,0,0
1455,78EE811F,0,2,2,1,0,0,0,0
1456,7FB8B2C1,1,0,1,0,0,0,0,0.003312
1457,791B30B7,1,0,1,0,0,0,0,0.003312
1458,80C335AB,0,1,1,1,0,0,0,0
1459,812331F6,7,1,8,1,11,0,0,0.03394
1460,79F4FCEA,1,0,1,0,0,0,0,0.003312
1461,7B5BE533,4,2,6,1,7,0,0,0.023449
1462,762DDD41,1,0,1,0,0,0,0,0.003312
1463,8036E9B7,1,1,2,1,0,0,0,0.003312
1464,7A860BEA,1,0,1,0,0,0,0,0.005241
1465,795E7196,2,1,3,1,1,0,0,0.006624
1466,5F43D8DE,1,1,2,1,1,0,0,0.003312
1467,77EE261B,0,2,2,1,0,0,0,0
1468,7C25C70B,2,0,2,0,0,0,0,0.006624
1469,7CD9BCD3,1,1,2,1,0,0,0,0.011058
1470,7967F8F0,1,0,1,0,0,0,0,0.003312
1471,7A28514D,3,0,3,0,0,0,0,0.009935
1472,78A8DF92,7,0,7,0,0,0.000009,0,0.038354
1473,7E43FFA8,1,2,3,1,2,0,0,0.003312
1474,7E78EE0C,3,0,3,0,0,0,0,0.011865
1475,7E6AF761,2,0,2,0,0,0,0,0.008553
1476,7A7321C0,1,0,1,0,0,0,0,0.003312
1477,7FE5D192,1,0,1,0,0,0,0,0.005241
1478,0A5AEA9C,1,0,1,0,0,0,0,0.005241
1479,7CB2E471,1,0,1,0,0,0,0,0.003312
1480,7993C506,1,0,1,0,0,0,0,0.003312
1481,7DB5F6D9,1,1,2,1,1,0,0,0.003312
1482,7D2171D2,4,7,11,0.509434,110.333333,0,0,0.017106
1483,761E1403,0,4,4,0.666667,0,0,0,0
1484,7CCC7EAD,1,0,1,0,0,0,0,0.003312
1485,80D9FEAA,0,1,1,0.666667,0,0,0,0
1486,7E976DBA,0,1,1,0.5,0,0,0,0
1487,76328B56,0,1,1,1,0,0,0,0
1488,7B72E256,3,2,5,0.5,10.166667,0,0,0.009935
1489,5AEAC16B,1,0,1,0,0,0,0,0.003312
1490,7ACAA2C6,0,1,1,1,0,0,0,0
1491,79547A50,1,1,2,1,1,0,0,0.003312
1492,7DA14AF1,0,1,1,0.666667,0,0,0,0
1493,7752C126,0,1,1,1,0,0,0,0
1494,720CC211,2,0,2,0,0,0,0,0.015782
1495,79C6D034,2,1,3,0.6,4.5,0,0,0.006624
1496,7781C4F8,1,0,1,0,0,0,0,0.003312
1497,589B88C3,1,0,1,0,0,0,0,0.003312
1498,01F300C9,0,1,1,0.352941,0,0,0,0
1499,7EBE0038,1,0,1,0,0,0,0,0.003312
1500,802C3CD4,0,2,2,1,0,0,0,0
1501,7F6D131B,0,3,3,1,0,0,0,0
1502,7A0E8559,1,0,1,0,0,0,0,0.003312
1503,7CF8079F,1,2,3,0.351852,18,0,0,0.003312
1504,7DB390BA,0,2,2,1,0,0,0,0
1505,7941837C,0,1,1,1,0,0,0,0
1506,7EEE7550,3,2,5,1,6,0,0,0.011865
1507,7A4492D8,1,0,1,0,0,0,0,0.003312
1508,7F0AAC13,1,2,3,0.555556,5,0,0,0.003312
1509,7BEEC842,1,0,1,0,0,0,0,0.003312
1510,8171F32A,0,1,1,1,0,0,0,0
1511,7AE0FBC4,2,0,2,0,0,0.023453,0,0.018042
1512,0236B96E,0,1,1,1,0,0,0,0
1513,7D37BB61,0,2,2,1,0,0,0,0
1514,5A13AC76,1,0,1,0,0,0,0,0.003312
1515,76DF3CA3,1,0,1,0,0,0,0,0.003312
1516,77816579,1,0,1,0,0,0,0,0.003312
1517,039BBF83,0,3,3,0.714286,0,0,0,0
1518,7D01EF7D,1,0,1,0,0,0,0,0.003312
1519,77FD921A,0,2,2,1,0,0,0,0
1520,7E72EE2B,0,1,1,0.666667,0,0,0,0
1521,809ED2B0,0,4,4,0.588235,0,0,0.000031,0
1522,7E91093C,0,2,2,0.75,0,0,0,0
1523,7C0ED5B6,0,1,1,1,0,0,0,0
1524,7BDD7AF0,1,0,1,0,0,0,0,0.003312
1525,77183156,0,3,3,1,0,0,0,0
1526,7A81CD5F,0,1,1,0.5,0,0,0,0
1527,76CFF695,0,1,1,0.666667,0,0,0,0
1528,7A71BB1A,0,1,1,1,0,0,0,0
1529,7EFB5E87,0,1,1,1,0,0,0,0
1530,7553E5BE,1,0,1,0,0,0,0,0.005241
1531,7C9D4470,0,2,2,1,0,0,0,0
1532,7831D3F1,3,1,4,0.666667,4,0,0,0.009935
1533,77A9F6D6,0,1,1,1,0,0,0.000363,0
1534,77761337,1,0,1,0,0,0,0,0.003312
1535,7696124C,1,0,1,0,0,0,0,0.003312
1536,7FD984AD,0,1,1,0.410256,0,0,0,0
1537,80013457,0,1,1,1,0,0,0,0
1538,78277F6B,2,0,2,0,0,0,0,0.006624
1539,7BEB3C31,1,4,5,0.615385,4,0,0,0.003312
1540,5C9DED15,0,1,1,0.666667,0,0,0,0
1541,80E9EA83,0,2,2,0.434783,0,0,0.000001,0
1542,7CF353D6,1,0,1,0,0,0,0,0.011982
1543,7BE64FC6,1,0,1,0,0,0,0,0.005241
1544,754C1627,6,8,14,0.75,68.5,0,0,0.025501
1545,769F5B10,3,0,3,0,0,0.027325,0,0.016279
1546,7896BB52,1,0,1,0,0,0,0,0.005796
1547,7D557F4A,2,0,2,0,0,0.000004,0,0.039348
1548,319A2B29,2,0,2,0,0,0,0,0.009108
1549,7C96C79F,0,1,1,1,0,0,0,0
1550,7FC5BFE2,1,0,1,0,0,0,0,0.003312
1551,780E2D66,1,0,1,0,0,0,0,0.003312
1552,8010BA87,2,0,2,0,0,0,0,0.006624
1553,80D8C3A1,1,1,2,0.666667,0,0,0,0.003312
1554,7841287E,1,0,1,0,0,0,0,0.005241
1555,2F0A9C4B,1,0,1,0,0,0,0,0.005241
1556,8060D66F,1,2,3,0.6,4,0,0.000001,0.003312
1557,80DA2A1D,2,1,3,1,2,0,0,0.006624
1558,7ABE9C5F,0,4,4,0.4,0,0,0,0
1559,7BDC8B41,0,1,1,1,0,0,0.027717,0
1560,7EF51CF1,0,3,3,1,0,0,0,0
1561,7979B12D,3,0,3,0,0,0,0,0.111432
1562,80979BFA,0,1,1,1,0,0,0,0
1563,7D9386A7,1,0,1,0,0,0,0,0.003312
1564,7B15D203,1,0,1,0,0,0,0,0.003312
1565,7F091BD6,2,0,2,0,0,0,0,0.008553
1566,815D80B7,6,1,7,1,6.5,0,0,0.034487
1567,7681AF3D,0,2,2,0.5,0,0,0,0
1568,7F5D9645,0,2,2,0.470588,0,0,0,0
1569,7CCE920F,0,2,2,0.75,0,0,0,0
1570,7C469E21,0,4,4,0.571429,0,0,0,0
1571,79F51189,3,0,3,0,0,0,0,0.071151
1572,7D7EB947,12,0,12,0,0,0,0,0.041671
1573,0AF4FF4E,1,0,1,0,0,0,0,0.003312
1574,813B726D,2,0,2,0,0,0,0,0.017427
1575,81688D9C,0,2,2,0.545455,0,0,0,0
1576,7D03D894,0,2,2,0.342857,0,0,0,0
1577,0176DB7A,2,0,2,0,0,0,0,0.011038
1578,77E16853,13,3,16,1,26.183333,0.178733,0.110692,0.330854
1579,7C78E67D,0,3,3,0.416667,0,0,0,0
1580,7ADC7788,1,1,2,1,0,0,0,0.003312
1581,763B8F1D,0,1,1,1,0,0,0,0
1582,7FF2C429,5,4,9,1,24.333333,0.000009,0.000011,0.022347
1583,7C181DAB,0,1,1,1,0,0,0,0
1584,5E8761C6,1,0,1,0,0,0,0,0.009655
1585,80B6010C,0,1,1,0.666667,0,0,0,0
1586,7C9FCCDC,0,2,2,0.75,0,0,0,0
1587,7BD5C2D6,2,2,4,0.666667,2,0.000005,0.000002,0.01931
1588,80A9FD6C,1,4,5,0.349206,22,0,0,0.003312
1589,7AF3CFA3,1,0,1,0,0,0,0,0.005796
1590,791ECA33,1,0,1,0,0,0,0,0.003312
1591,810EF1A0,1,0,1,0,0,0,0,0.003312
1592,77861BBE,0,1,1,0.6,0,0,0,0
1593,78D9B1B9,0,1,1,1,0,0,0,0
1594,7ED51E59,3,3,6,0.714286,25,0,0,0.013794
1595,7A150A34,0,1,1,0.666667,0,0,0,0
1596,7D45B42E,1,1,2,0.666667,0,0,0,0.003312
1597,7DFDD32C,2,0,2,0,0,0,0,0.008553
1598,7FF1F05D,0,1,1,1,0,0,0,0
1599,5CD299B8,1,0,1,0,0,0,0,0.003312
1600,7AE4F7C0,4,2,6,0.44,37.361111,0,0,0.044169
1601,817363A8,0,1,1,0.351351,0,0,0,0
1602,788DEEAC,0,1,1,0.666667,0,0,0,0
1603,7FE37AFA,1,0,1,0,0,0,0,0.003312
1604,7E8FE7E9,0,2,2,0.5,0,0,0,0
1605,7DD5E647,2,2,4,1,2.75,0,0,0.006624
1606,77D0084D,6,5,11,1,42,0,0,0.030628
1607,7E679A28,1,0,1,0,0,0,0,0.005241
1608,80C376F4,1,0,1,0,0,0,0,0.007726
1609,7F51F3F8,1,1,2,1,2,0,0,0.005241
1610,7F5E857E,1,0,1,0,0,0,0,0.003312
1611,7A0E2C23,1,0,1,0,0,0,0,0.003312
1612,7D12E334,1,0,1,0,0,0,0,0.003312
1613,790A73AA,0,7,7,0.361789,0,0,0,0
1614,76124A2A,0,1,1,1,0,0,0,0
1615,76BE8E84,0,12,12,0.454545,0,0,0.205378,0
1616,7D3FEF74,2,0,2,0,0,0,0,0.025946
1617,78F42ECF,0,1,1,1,0,0,0,0
1618,78134C20,0,1,1,1,0,0,0,0
1619,782EE50E,1,1,2,1,0,0,0,0.005241
1620,7F0390D0,0,3,3,0.714286,0,0,0,0
1621,75E0BD8B,0,1,1,0.666667,0,0,0,0
1622,7F59B6C4,2,2,4,0.545455,1.180556,0,0,0.013072
1623,78E8BC27,1,0,1,0,0,0,0,0.003312
1624,7D9A035E,2,0,2,0,0,0,0,0.006624
1625,624FE56A,1,0,1,0,0,0,0,0.003312
1626,79B9B965,0,1,1,1,0,0,0,0
1627,81AF210E,1,0,1,0,0,0,0,0.003312
1628,7E4BECA5,0,1,1,1,0,0,0,0
1629,75C99011,0,1,1,1,0,0,0,0
1630,7EBF89DB,2,7,9,0.446809,9,0,0,0.008553
1631,7E43C443,0,1,1,1,0,0,0,0
1632,7AD04E6E,0,3,3,0.714286,0,0,0,0
1633,75C64510,0,1,1,0.454545,0,0,0,0
1634,79AB8852,2,0,2,0,0,0,0,0.006624
1635,7A4EC918,1,0,1,0,0,0,0,0.003312
1636,7C66574A,1,0,1,0,0,0,0,0.003312
1637,79C7F26D,9,3,12,0.538462,81.333333,0,0,0.19711
1638,7F7E46C9,0,2,2,0.75,0,0,0,0
1639,7ED81272,0,2,2,0.75,0,0,0,0
1640,7E22A99E,0,1,1,0.5,0,0,0,0
1641,7E612398,0,2,2,0.75,0,0,0,0
1642,7BBFEF1E,1,0,1,0,0,0,0,0.003312
1643,06CF3B40,1,0,1,0,0,0,0,0.003312
1644,7B27D6B2,0,3,3,0.454545,0,0,0.00003,0
1645,7BAE71CA,5,1,6,0.6,9,0,0,0.023563
1646,5CC02EA3,0,3,3,0.363636,0,0,0,0
1647,58B67F9B,1,0,1,0,0,0.000037,0,0.005241
1648,7DE8A4EB,13,1,14,1,19,0,0,0.108408
1649,7F39B5C3,1,0,1,0,0,0,0,0.003312
1650,79CBFE9C,1,0,1,0,0,0,0,0.003312
1651,7CCBD8A4,1,0,1,0,0,0,0,0.003312
1652,799F1B91,1,0,1,0,0,0,0,0.003312
1653,80F8B052,0,1,1,1,0,0,0,0
1654,7CF49837,0,7,7,0.575758,0,0,0,0
1655,76EBEA14,0,5,5,0.555556,0,0,0,0
1656,79137827,1,0,1,0,0,0,0,0.003312
1657,7D682AA5,6,2,8,1,66.5,0,0,0.060138
1658,778247F8,0,2,2,1,0,0,0,0
1659,7E12CAA1,6,4,10,1,45.666667,0,0,0.060024
1660,80E4884E,2,0,2,0,0,0,0,0.008553
1661,7AA6D1DD,1,0,1,0,0,0,0,0.003312
1662,7FF81E80,0,1,1,0.5,0,0,0,0
1663,75CC8AEF,4,0,4,0,0,0,0,0.027179
1664,7FAE54AF,5,0,5,0,0,0,0,0.048614
1665,7B3AB225,2,0,2,0,0,0,0,0.006624
1666,80737636,1,0,1,0,0,0,0,0.003312
1667,7D46815C,0,2,2,1,0,0,0,0
1668,77FBC1CA,10,3,13,0.358209,117.111111,0,0,0.051066
1669,7E9EC20F,1,0,1,0,0,0,0,0.003312
1670,78F3537D,1,0,1,0,0,0,0,0.003312
1671,7DDB7D8E,0,3,3,0.533333,0,0,0,0
1672,7827685F,1,0,1,0,0,0.000004,0,0.003312
1673,7A9A8446,0,2,2,1,0,0,0,0
1674,7D62D9F3,10,0,10,0,0,0,0,0.098292
1675,7A7AD91C,0,2,2,1,0,0,0,0
1676,7C23C389,1,0,1,0,0,0,0,0.003312
1677,7623E6F4,1,0,1,0,0,0,0,0.003312
1678,7A05180D,0,1,1,1,0,0,0,0
1679,7731B773,4,2,6,0.5,12.5,0,0,0.022736
1680,792835CC,0,1,1,1,0,0,0,0
1681,77A4F711,0,2,2,1,0,0,0,0
1682,7B7BE4C9,0,1,1,0.666667,0,0,0,0
1683,7656E445,1,0,1,0,0,0,0,0.003312
1684,79087D14,0,1,1,1,0,0,0,0
1685,805B5C40,3,0,3,0,0,0,0,0.018208
1686,7D6F5129,0,2,2,1,0,0,0,0
1687,5920AEB7,0,1,1,1,0,0,0,0
1688,784AB38B,0,3,3,0.397849,0,0,0,0
1689,7C78D9CC,1,1,2,1,2,0,0,0.005241
1690,7B7F6A68,0,3,3,0.457143,0,0,0.034084,0
1691,7F57DFE4,0,2,2,1,0,0,0,0
1692,78FE23B4,1,1,2,1,0.5,0,0,0.003312
1693,818C1230,1,0,1,0,0,0,0,0.003312
1694,7EF1139C,1,4,5,0.365591,20,0,0,0.003312
1695,75AE96FE,1,0,1,0,0,0,0,0.003312
1696,803DCF32,2,1,3,1,2,0,0,0.006624
1697,5893A64C,0,1,1,1,0,0,0,0
1698,76DCFD4B,2,0,2,0,0,0,0,0.010482
1699,7F931C0D,1,3,4,0.6,2,0,0,0.003312
1700,769732BC,1,0,1,0,0,0,0,0.003312
1701,7F3D4308,0,1,1,1,0,0,0,0
1702,8110ADA2,1,0,1,0,0,0,0,0.003312
1703,768EB506,0,1,1,1,0,0,0,0
1704,75C89A8A,1,0,1,0,0,0,0,0.003312
1705,7D4D5B61,0,2,2,1,0,0,0,0
1706,7CFC7537,2,1,3,1,0,0,0,0.006624
1707,7A8A69CE,1,0,1,0,0,0,0,0.003312
1708,7A1C953F,1,0,1,0,0,0,0,0.003312
1709,7BED7B86,0,1,1,1,0,0,0,0
1710,77BF3434,1,0,1,0,0,0,0,0.005241
1711,77C0C7FC,1,0,1,0,0,0,0,0.003312
1712,7D722831,0,1,1,0.4375,0,0,0.000001,0
1713,7CE5DF4F,1,0,1,0,0,0,0,0.003312
1714,7D0772E5,1,0,1,0,0,0,0,0.003312
1715,7836F066,3,0,3,0,0,0,0,0.011865
1716,7CC5036B,0,4,4,0.38806,0,0,0,0
1717,776E9624,1,6,7,0.571429,10.583333,0,0,0.016817
1718,7BABB698,0,1,1,1,0,0,0,0
1719,7D24F953,0,1,1,1,0,0,0,0
1720,806D5165,0,2,2,1,0,0,0,0
1721,7577866C,1,0,1,0,0,0.006898,0,0.003312
1722,7DE9E39A,0,1,1,0.6,0,0,0,0
1723,7F61D10A,1,0,1,0,0,0,0,0.003312
1724,7AA19D04,5,2,7,1,8.5,0,0.000001,0.024832
1725,768366D9,10,0,10,0,0,0,0,0.045249
1726,7DEA01E3,0,1,1,0.538462,0,0,0,0
1727,7FA1E17A,1,1,2,1,1,0,0,0.003312
1728,75D49C48,1,0,1,0,0,0,0,0.003312
1729,7BA57373,0,1,1,1,0,0,0,0
1730,7734AFD3,0,1,1,1,0,0,0,0
1731,7E162D29,6,1,7,1,36,0,0,0.063997
1732,7CABACBD,0,3,3,1,0,0,0,0
1733,778369D1,1,3,4,0.478261,18,0.000004,0.000004,0.005241
1734,76937C1C,1,0,1,0,0,0,0,0.005241
1735,7C70E836,1,0,1,0,0,0,0,0.003312
1736,5E50EE8F,0,2,2,0.313433,0,0,0.000035,0
1737,8068B815,1,0,1,0,0,0,0,0.005241
1738,765D054B,0,3,3,0.481481,0,0,0.000009,0
1739,78335C14,0,1,1,1,0,0,0,0
1740,81791A5A,7,1,8,1,6.933333,0,0,0.079122
1741,7D3DB1A7,1,2,3,0.75,3,0,0,0.003312
1742,780674DB,9,2,11,1,28,0,0,0.041937
1743,7EA8DE4F,2,1,3,1,2,0,0,0.006624
1744,80FE8D69,3,0,3,0,0,0,0,0.032558
1745,7D9EBCA0,1,1,2,1,1,0,0,0.003312
1746,7F415AB4,0,1,1,1,0,0,0,0
1747,7D299C10,1,4,5,1,0,0,0,0.003312
1748,7ED53101,0,1,1,0.281818,0,0,0,0
1749,80F7D59F,0,5,5,1,0,0,0,0
1750,76078C7D,1,2,3,0.75,3,0,0,0.003312
1751,77E9D08C,1,0,1,0,0,0,0,0.003312
1752,7C2ED395,32,1,33,0.5,90.136111,0,0,0.323855
1753,7BD82C42,1,0,1,0,0,0,0,0.003312
1754,7E688B3D,0,2,2,0.75,0,0,0,0
1755,800ABB69,10,1,11,1,28,0,0,0.057079
1756,76AB4766,1,0,1,0,0,0,0,0.003312
1757,804A777F,0,2,2,0.403509,0,0,0,0
1758,81219DC4,0,1,1,1,0,0,0,0
1759,791C4782,0,1,1,1,0,0,0,0
1760,7A39260B,3,0,3,0,0,0,0,0.009935
1761,7C90F1F3,7,1,8,1,50,0,0,0.099229
1762,7792F901,0,5,5,0.364706,0,0,0,0
1763,1218BFC8,0,5,5,0.727273,0,0,0.179711,0
1764,76A233D4,2,1,3,1,3,0,0,0.008553
1765,8007FB4D,3,1,4,0.5,20,0,0,0.014349
1766,7E078C89,1,0,1,0,0,0,0,0.003312
1767,7E9CDA2A,0,1,1,1,0,0,0,0
1768,7BCF0DB1,3,5,8,1,35,0,0,0.020137
1769,7F435915,1,1,2,0.666667,2,0,0,0.003312
1770,7712CF42,2,0,2,0,0,0.000008,0,0.012967
1771,5B29ACF5,0,1,1,1,0,0,0,0
1772,807181A5,0,2,2,0.75,0,0,0,0
1773,801AA05F,0,3,3,1,0,0,0,0
1774,758560E5,0,1,1,0.366972,0,0,0,0
1775,750E2CA7,1,0,1,0,0,0,0,0.003312
1776,7D5545E1,1,1,2,1,1,0,0,0.003312
1777,77001ED9,5,0,5,0,0,0,0,0.022347
1778,75895A62,1,0,1,0,0,0,0,0.003312
1779,7866B375,0,4,4,0.666667,0,0,0,0
1780,78D1DC80,0,1,1,1,0,0,0,0
1781,80FA3CA9,4,1,5,0.375,6,0,0,0.015176
1782,77FEB43D,2,1,3,0.410256,37.785714,0,0,0.011038
1783,7D1068A2,2,2,4,0.666667,8,0,0,0.006624
1784,7FC4AE24,0,3,3,0.545455,0,0,0.053261,0
1785,7EDE313C,3,0,3,0,0,0,0,0.075922
1786,7752B0B7,2,0,2,0,0,0,0,0.017065
1787,7D64F585,0,1,1,1,0,0,0,0
1788,773D14A8,0,2,2,0.5,0,0,0,0
1789,814B1B38,0,1,1,1,0,0,0,0
1790,7F4C6CE1,0,8,8,0.545455,0,0,0,0
1791,7E92BE59,1,2,3,0.666667,4,0.000001,0,0.003312
1792,7D3D2C76,0,3,3,0.381818,0,0,0,0
1793,77FDBA64,1,1,2,0.6,0,0,0,0.005241
1794,817769CE,0,1,1,1,0,0,0,0
1795,76C7058D,1,0,1,0,0,0,0,0.003312
1796,15770A8C,1,1,2,1,0.5,0.000039,0.000033,0.003312
1797,76624F55,1,0,1,0,0,0,0,0.003312
1798,7880CF6D,0,1,1,1,0,0,0,0
1799,78B329B7,1,0,1,0,0,0,0,0.003312
1800,7C90083C,1,0,1,0,0,0,0,0.005241
1801,7B74F21A,2,0,2,0,0,0,0,0.008553
1802,7C20DB1D,1,0,1,0,0,0,0,0.00717
1803,80B6156A,0,4,4,0.833333,0,0,0,0
1804,75C00156,1,1,2,1,1,0,0,0.003312
1805,7E5E3E79,4,0,4,0,0,0.000288,0,0.017106
1806,816EC63C,3,1,4,1,16.330159,0,0,0.159472
1807,588D382F,0,2,2,1,0,0,0,0
1808,81200207,0,1,1,1,0,0,0,0
1809,7C8D8DD5,1,0,1,0,0,0,0,0.005241
1810,76B1D4C0,1,2,3,1,2,0,0,0.005241
1811,7C1ADC66,1,0,1,0,0,0,0,0.003312
1812,7BD44729,4,1,5,1,5,0,0,0.02152
1813,754395F3,1,1,2,0.5,5,0,0,0.003312
1814,7CCD249E,0,2,2,1,0,0,0,0
1815,7E72C8D0,1,7,8,0.3625,13,0,0,0.005241
1816,5D8B6E2D,4,0,4,0,0,0,0,0.083389
1817,7B00F8AE,2,1,3,1,1,0,0,0.006624
1818,7BCAD33A,1,0,1,0,0,0,0,0.003312
1819,774EE114,0,1,1,1,0,0,0,0
1820,75807FDA,2,0,2,0,0,0,0,0.006624
1821,6088F026,2,0,2,0,0,0,0,0.006624
1822,79173955,1,0,1,0,0,0,0,0.005241
1823,755D0CA1,1,0,1,0,0,0,0,0.005241
1824,80192E75,0,1,1,1,0,0,0,0
1825,75EFC820,1,0,1,0,0,0,0,0.003312
1826,7F710D93,3,2,5,1,5,0,0,0.009935
1827,7AB03907,0,2,2,0.75,0,0,0,0
1828,7938922D,2,0,2,0,0,0,0,0.008553
1829,603362BF,1,0,1,0,0,0,0,0.003312
1830,7FE86EE9,0,1,1,1,0,0,0,0
1831,26AB81D2,1,0,1,0,0,0,0,0.003312
1832,7EDFB313,2,2,4,0.35,21.833333,0,0,0.006624
1833,781226C9,1,0,1,0,0,0,0,0.003312
1834,7D8F9CDA,0,2,2,0.666667,0,0,0,0
1835,80EBF4CC,1,1,2,1,1,0,0,0.003312
1836,7F19FDAD,0,3,3,1,0,0,0,0
1837,80460A8A,0,1,1,1,0,0,0,0
1838,7EB959DB,0,1,1,1,0,0,0,0
1839,80BB8E38,0,2,2,1,0,0,0,0
1840,7D7F413C,0,1,1,1,0,0,0,0
1841,7C9D8E68,0,1,1,1,0,0,0,0
1842,7534BD50,0,1,1,1,0,0,0,0
1843,810F571A,0,2,2,1,0,0,0,0
1844,7A1722E5,9,18,27,0.614035,334.31746,0,0,0.0528
1845,7F2E7651,2,12,14,1,24,0,0,0.006624
1846,7F1E69B6,2,2,4,1,4,0,0,0.008553
1847,7C5E3CC4,1,0,1,0,0,0,0,0.003312
1848,79DFF6EE,1,0,1,0,0,0,0,0.003312
1849,80E72713,0,3,3,1,0,0,0,0
1850,7FC58F18,2,0,2,0,0,0,0,0.006624
1851,82028128,0,2,2,0.409091,0,0,0,0
1852,7FA6F4EC,2,0,2,0,0,0,0,0.006624
1853,7FF007A4,2,0,2,0,0,0,0,0.008553
1854,789F7E40,2,0,2,0,0,0,0,0.008553
1855,7D513995,3,2,5,1,90,0,0,0.040275
1856,7C43E0D4,0,2,2,0.342105,0,0,0,0
1857,80A38731,2,0,2,0,0,0,0,0.009108
1858,8061C727,1,2,3,1,2,0,0,0.003312
1859,7E4754B8,44,2,46,0.666667,546.919048,0,0,0.483819
1860,7ADB2EDC,1,0,1,0,0,0,0,0.003312
1861,7CB873CC,0,1,1,1,0,0,0,0
1862,7B7E867C,1,0,1,0,0,0,0,0.003312
1863,78B87BF2,2,0,2,0,0,0,0,0.018191
1864,7EC56B7F,0,1,1,1,0,0,0,0
1865,7D9CDF5A,1,0,1,0,0,0,0,0.003312
1866,7F06C6C7,0,1,1,1,0,0,0,0
1867,76DB649C,0,1,1,0.5,0,0,0,0
1868,7EF6BC14,0,5,5,0.588235,0,0,0,0
1869,7A67AA94,0,1,1,1,0,0,0,0
1870,7C11DA44,0,2,2,0.666667,0,0,0,0
1871,6145019D,1,0,1,0,0,0,0,0.003312
1872,793577BE,2,1,3,1,2,0,0,0.006624
1873,79BC8169,0,3,3,0.545455,0,0,0,0
1874,78A2973C,3,0,3,0,0,0,0,0.021909
1875,7C009CCA,0,1,1,1,0,0,0,0
1876,7B6412D3,2,0,2,0,0,0,0,0.009108
1877,7DCAE6A6,1,0,1,0,0,0,0,0.003312
1878,810CBF3D,3,3,6,0.466667,8.228571,0,0,0.044798
1879,7BB8E735,1,2,3,1,2,0,0.000366,0.003312
1880,616CF0AE,3,0,3,0,0,0,0,0.028094
1881,8083766A,0,1,1,1,0,0,0,0
1882,76E74E5A,1,0,1,0,0,0,0,0.003312
1883,77DB328F,2,0,2,0,0,0,0,0.006624
1884,7764B55B,5,0,5,0,0,0,0,0.028427
1885,80E3AE90,1,0,1,0,0,0,0,0.003312
1886,6D2465F9,0,1,1,1,0,0,0,0
1887,783C7901,1,0,1,0,0,0,0,0.003312
1888,75B67ACC,0,1,1,1,0,0,0,0
1889,7AE3D4CF,2,0,2,0,0,0,0,0.006624
1890,7B116645,0,1,1,1,0,0,0,0
1891,79639CA3,1,1,2,1,1,0,0,0.003312
1892,7CD789B4,1,0,1,0,0,0,0,0.003312
1893,7B4C53A7,4,0,4,0,0,0,0,0.02152
1894,7EA6D1C0,1,0,1,0,0,0,0,0.003312
1895,7CA3C6B9,0,2,2,0.4375,0,0,0,0
1896,75F8A236,0,1,1,1,0,0,0,0
1897,7AEFE5D9,1,0,1,0,0,0,0,0.003312
1898,80022A40,0,1,1,1,0,0,0,0
1899,7F34E6CF,3,0,3,0,0,0,0,0.025654
1900,7B823379,1,0,1,0,0,0,0,0.003312
1901,80597126,0,3,3,0.291667,0,0,0,0
1902,780DE9F8,0,5,5,0.666667,0,0,0,0
1903,7A61FCF8,9,1,10,1,11.719048,0,0,0.130328
1904,815C45F7,2,0,2,0,0,0,0,0.022456
1905,5839157F,1,0,1,0,0,0,0,0.005241
1906,60C97D37,1,0,1,0,0,0,0,0.003312
1907,81178ED2,0,1,1,1,0,0,0,0
1908,809BC5E4,0,1,1,1,0,0,0,0
1909,777EA979,0,1,1,1,0,0,0,0
1910,6EEBEA14,0,2,2,0.75,0,0,0.000035,0
1911,752E7B4D,1,0,1,0,0,0,0,0.003312
1912,7CD3001B,2,0,2,0,0,0,0,0.008553
1913,5F8052E4,5,1,6,0.5,18,0,0,0.020973
1914,7840C8A6,2,0,2,0,0,0,0,0.008553
1915,77DA9200,4,0,4,0,0,0,0,0.024838
1916,81605452,1,0,1,0,0,0,0,0.003312
1917,76384B68,2,5,7,0.727273,2.033333,0.024796,0.163207,0.012967
1918,7E0ADB82,0,1,1,0.52,0,0,0,0
1919,7E202444,0,2,2,1,0,0,0,0
1920,7B0759EB,3,0,3,0,0,0,0,0.018208
1921,77C83937,0,3,3,1,0,0,0,0
1922,7B5E8CB3,13,0,13,0,0,0,0,0.08603
1923,5C25A1EB,2,0,2,0,0,0,0,0.006624
1924,7BD191B5,0,3,3,0.423611,0,0,0,0
1925,759DF067,1,0,1,0,0,0,0,0.003312
1926,7A5DF2C7,0,1,1,0.333333,0,0,0,0
1927,800CB573,4,0,4,0,0,0,0,0.015176
1928,80BA8FEA,0,1,1,1,0,0,0,0
1929,5E6B2C10,0,6,6,0.875,0,0,0,0
1930,7D7CB52A,0,1,1,1,0,0,0,0
1931,7D976F31,1,0,1,0,0,0,0,0.003312
1932,06E45518,1,0,1,0,0,0,0,0.009655
1933,7C85A688,1,0,1,0,0,0,0,0.005241
1934,79EAD33C,1,0,1,0,0,0,0,0.005796
1935,7E8A8075,0,3,3,0.365854,0,0,0,0
1936,7F4049F2,2,1,3,1,1,0,0,0.025946
1937,7F9E3CA7,1,0,1,0,0,0,0,0.003312
1938,75E48087,0,1,1,1,0,0,0,0
1939,78A62A51,1,0,1,0,0,0,0,0.005241
1940,77F22E98,1,0,1,0,0,0,0,0.003312
1941,7E6FC5A2,0,1,1,0.666667,0,0,0,0
1942,6C99D32E,1,0,1,0,0,0,0,0.003312
1943,79BB6C69,0,1,1,1,0,0,0,0
1944,7562E478,0,2,2,1,0,0,0,0
1945,817916B1,0,1,1,1,0,0,0,0
1946,06A23A6E,1,0,1,0,0,0,0,0.003312
1947,7DBF12B3,0,1,1,1,0,0,0,0
1948,5A5620D0,0,8,8,0.522727,0,0,0,0
1949,7EE4251C,1,0,1,0,0,0,0,0.003312
1950,7AA269CB,0,3,3,0.714286,0,0,0,0
1951,7F38F73C,1,1,2,1,1,0,0,0.003312
1952,7FBF2CF9,4,7,11,0.666667,40.5,0,0,0.021362
1953,7AA0F780,1,2,3,0.75,7.333333,0,0,0.016817
1954,79D28FB5,6,8,14,0.65,266.585714,0,0,0.110599
1955,813EDF33,0,1,1,1,0,0,0,0
1956,7EA80CDF,1,0,1,0,0,0,0,0.003312
1957,77AEFB3B,0,1,1,1,0,0,0,0
1958,76E62C8C,3,1,4,0.5,14,0,0,0.011865
1959,7A4401D4,3,1,4,1,3,0,0,0.009935
1960,7FDA0008,1,0,1,0,0,0,0,0.003312
1961,76D27320,0,1,1,0.5,0,0,0,0
1962,7DAF6576,0,2,2,1,0,0,0,0
1963,7153F279,1,0,1,0,0,0,0,0.003312
1964,611E454B,1,0,1,0,0,0,0,0.019805
1965,7C51C6FF,0,1,1,1,0,0,0,0
1966,79B1A3C3,0,2,2,0.409091,0,0,0,0
1967,7BD64170,1,0,1,0,0,0,0,0.003312
1968,80420EF4,3,0,3,0,0,0,0,0.009935
1969,797C8394,1,0,1,0,0,0,0,0.003312
1970,7CAFB0E7,0,1,1,1,0,0,0,0
1971,75ECE83F,2,0,2,0,0,0,0,0.010482
1972,7EA577DE,0,1,1,0.666667,0,0,0,0
1973,81163792,0,5,5,0.455882,0,0,0,0
1974,6DCF5868,1,0,1,0,0,0,0,0.011044
1975,7F60D6FD,0,2,2,1,0,0,0,0
1976,7B0AE953,1,0,1,0,0,0,0,0.003312
1977,76A5BE6C,2,0,2,0,0,0,0,0.006624
1978,77265063,2,1,3,0.470588,25.5,0,0,0.012412
1979,77DED92F,1,0,1,0,0,0,0,0.003312
1980,8016B89D,1,0,1,0,0,0,0,0.007726
1981,79190876,4,0,4,0,0,0,0,0.017661
1982,7BC8B7D5,0,1,1,1,0,0,0,0
1983,5A5582FD,0,1,1,0.666667,0,0,0,0
1984,7886DE32,0,1,1,0.6,0,0,0,0
1985,7AF9EE58,1,0,1,0,0,0,0,0.003312
1986,7A572221,1,3,4,0.666667,6,0,0.000021,0.003312
1987,8131EA5D,5,3,8,1,13.166667,0,0,0.024276
1988,7E3A72F8,2,3,5,0.292929,14.666667,0,0,0.008553
1989,8103B54F,1,0,1,0,0,0,0,0.003312
1990,606CCFD8,1,0,1,0,0,0,0,0.006352
1991,751C9860,0,3,3,0.409091,0,0,0,0
1992,7ECECEF3,0,1,1,1,0,0,0,0
1993,80BBF518,4,2,6,1,25,0,0,0.051119
1994,7A6082AF,0,2,2,1,0,0,0,0
1995,7966F2BE,3,0,3,0,0,0,0,0.009935
1996,7571775A,5,1,6,1,32,0,0,0.129116
1997,5D3615B5,1,0,1,0,0,0,0,0.003312
1998,81403416,1,0,1,0,0,0,0,0.005241
1999,775577CC,0,1,1,1,0,0,0,0
2000,260578C2,1,0,1,0,0,0.014142,0,0.0128
2001,7547FCA5,0,1,1,0.5,0,0,0,0
2002,7FD06F2B,3,1,4,1,3,0,0,0.011865
2003,7F991F45,0,2,2,0.666667,0,0,0,0
2004,798F03B6,2,1,3,0.323529,9,0,0,0.006624
2005,81330E44,0,1,1,0.5,0,0,0,0
2006,785AB04F,1,0,1,0,0,0,0,0.003312
2007,7E960CF6,1,0,1,0,0,0,0,0.036236
2008,8144CB83,1,0,1,0,0,0,0,0.003312
2009,80AC537B,5,3,8,0.571429,58,0,0,0.032368
2010,7A92B16F,1,0,1,0,0,0,0,0.003312
2011,7A71C62D,4,0,4,0,0,0,0,0.01959
2012,81082C2B,3,10,13,0.681818,100.166667,0,0,0.035256
2013,770818A7,0,3,3,1,0,0,0,0
2014,79C7B35F,3,0,3,0,0,0,0,0.017653
2015,7947F6C5,1,0,1,0,0,0,0,0.00717
2016,75412B56,1,4,5,0.5,38,0,0,0.00717
2017,7C4BB731,0,3,3,1,0,0,0,0
2018,75F3C3DE,0,3,3,0.8,0,0,0,0
2019,800081D1,1,1,2,0.666667,2,0,0,0.003312
2020,803BE815,0,1,1,1,0,0,0,0
2021,7B10F41C,1,0,1,0,0,0,0,0.003312
2022,77AB4DF3,1,0,1,0,0,0,0,0.003312
2023,7D595F21,0,2,2,0.409091,0,0,0,0
2024,7AC60F52,2,0,2,0,0,0.000159,0,0.01931
2025,7671474E,0,5,5,0.777778,0,0,0,0
2026,7D7BF8E3,19,0,19,0,0,0.273015,0,0.143262
2027,7EC10548,0,2,2,0.571429,0,0,0,0
2028,7876CC77,1,0,1,0,0,0,0,0.003312
2029,802AD03E,7,10,17,0.617647,95.416667,0,0,0.029526
2030,756435F8,25,7,32,0.652174,745.996032,0,0,0.31228
2031,77044F5E,0,4,4,0.833333,0,0,0,0
2032,04EC14DF,1,0,1,0,0,0,0,0.038219
2033,79462E6C,3,0,3,0,0,0,0,0.009935
2034,75733B58,0,2,2,0.75,0,0,0,0
2035,7825E40F,1,4,5,0.642857,5,0,0.000001,0.003312
2036,76319383,0,3,3,1,0,0,0,0
2037,7862D6CC,2,1,3,1,0,0,0,0.008553
2038,7A1C6AC5,3,0,3,0,0,0,0,0.009935
2039,7624176C,1,2,3,0.666667,0,0,0,0.003312
2040,7E30C629,3,0,3,0,0,0,0,0.009935
2041,7B13AAD3,1,0,1,0,0,0,0,0.003312
2042,7D52C8E1,0,1,1,1,0,0,0,0
2043,59DE3520,0,1,1,1,0,0,0,0
2044,80028082,2,0,2,0,0,0,0,0.006624
2045,7B032EE8,1,0,1,0,0,0,0,0.005241
2046,7A66BABD,0,1,1,1,0,0,0,0
2047,7B89C311,1,0,1,0,0,0,0,0.003312
2048,79505858,3,0,3,0,0,0,0,0.011865
2049,7A5ADB1B,0,1,1,1,0,0,0,0
2050,7ACE721E,2,0,2,0,0,0,0,0.008553
2051,7D293A4C,1,0,1,0,0,0,0,0.003312
2052,80B5AFCD,0,7,7,0.345324,0,0,0,0
2053,7B9B608F,0,1,1,1,0,0,0,0
2054,7D42B64A,0,3,3,0.8,0,0,0,0
2055,7E9AFEFF,0,2,2,0.5,0,0,0,0
2056,76D0BF70,2,2,4,0.533333,1.47619,0,0,0.008553
2057,814FAA6C,1,0,1,0,0,0,0,0.003312
2058,79733C45,3,3,6,0.714286,12,0,0,0.011865
2059,771F74BF,1,0,1,0,0,0,0,0.003312
2060,76718480,1,0,1,0,0,0,0,0.003312
2061,78797745,1,0,1,0,0,0,0,0.005241
2062,5C35EC63,1,1,2,1,0,0,0,0.005241
2063,7E78288F,1,0,1,0,0,0,0,0.00717
2064,7B21A259,5,0,5,0,0,0,0,0.024276
2065,7A9CDF86,0,6,6,1,0,0,0,0
2066,7C91AD52,1,0,1,0,0,0,0,0.003312
2067,7AE07E39,1,0,1,0,0,0,0,0.003312
2068,78345E58,0,2,2,0.75,0,0,0,0
2069,6277BE00,1,0,1,0,0,0,0,0.00717
2070,5AA5FC1B,0,1,1,1,0,0,0,0
2071,7F566CBB,7,0,7,0,0,0,0,0.127698
2072,7F17AD11,3,2,5,1,6,0,0,0.011865
2073,7F22EB34,0,2,2,0.555556,0,0,0,0
2074,77BCD374,1,0,1,0,0,0,0,0.003312
2075,63397A89,1,0,1,0,0,0,0,0.003312
2076,75A61A76,0,1,1,1,0,0,0,0
2077,8128CA3F,1,0,1,0,0,0,0,0.003312
2078,7E80EA3A,0,1,1,1,0,0,0,0
2079,803E9B29,0,1,1,1,0,0,0,0
2080,753827CE,0,2,2,1,0,0,0,0
2081,765E97AE,2,3,5,1,4.5,0,0,0.006624
2082,782BCC8C,1,3,4,0.625,1.5,0,0,0.003312
2083,774EE741,0,1,1,1,0,0,0,0
2084,7FA70CBD,0,1,1,0.268293,0,0,0,0
2085,77385041,0,1,1,0.666667,0,0,0,0
2086,7F11EB69,2,1,3,1,3,0,0,0.008553
2087,7FE43A7F,2,0,2,0,0,0,0,0.006624
2088,795E0E29,0,6,6,0.565217,0,0,0.000001,0
2089,7A551EE2,1,0,1,0,0,0,0,0.005241
2090,8174CA7F,2,0,2,0,0,0,0,0.013522
2091,7DEF5237,1,1,2,1,1,0,0,0.003312
2092,79A318E0,0,6,6,0.335329,0,0,0,0
2093,779E6008,1,6,7,0.357143,1.25,0,0,0.00717
2094,76737C2F,1,0,1,0,0,0,0,0.003312
2095,79C6ECED,1,0,1,0,0,0,0,0.003312
2096,77A5C601,0,3,3,0.8,0,0,0,0
2097,7F45AEE8,2,2,4,0.6,1,0,0,0.006624
2098,759DCF70,1,0,1,0,0,0,0,0.003312
2099,81777C90,1,0,1,0,0,0,0,0.003312
2100,80A995A5,0,3,3,0.5,0,0,0.000001,0
2101,80047EE2,0,1,1,1,0,0,0,0
2102,7F1F8E90,1,0,1,0,0,0,0,0.003312
2103,7C9D4AF0,0,2,2,0.325,0,0,0,0
2104,7CAEAB88,1,1,2,1,1,0,0,0.003312
2105,7BA352C2,0,1,1,1,0,0,0,0
2106,80306C60,9,2,11,0.461538,51.083333,0,0,0.099146
2107,7D73C470,0,3,3,0.8,0,0,0,0
2108,79428D0F,1,0,1,0,0,0,0,0.003312
2109,01D246F3,1,0,1,0,0,0,0,0.009655
2110,7F86B2B0,0,1,1,1,0,0,0,0
2111,80E02CF1,0,1,1,1,0,0,0,0
2112,78B57E6D,1,4,5,0.428571,8.666667,0,0,0.003312
2113,7596C624,0,2,2,1,0,0,0,0
2114,7A1B10EB,3,6,9,0.692308,25,0,0,0.011865
2115,77AFB2E1,1,0,1,0,0,0,0,0.003312
2116,7B2DC60F,1,1,2,1,0,0,0,0.003312
2117,7E35135F,1,1,2,1,1,0,0,0.003312
2118,75E413A6,0,3,3,0.8,0,0,0,0
2119,7CB48568,3,0,3,0,0,0,0,0.015723
2120,7D3A1859,6,0,6,0,0,0,0,0.033879
2121,7F9CA6AD,1,0,1,0,0,0,0,0.003312
2122,7846B7BB,0,3,3,0.444444,0,0,0,0
2123,76DD8E78,0,1,1,1,0,0,0,0
2124,802F462F,0,2,2,0.75,0,0,0,0
2125,7ECA1181,1,0,1,0,0,0,0,0.005241
2126,7DFEF070,0,1,1,1,0,0,0,0
2127,806CB2CA,2,2,4,1,4,0,0,0.006624
2128,7A0257DD,1,0,1,0,0,0,0,0.003312
2129,7E083A87,0,1,1,0.666667,0,0,0,0
2130,09BC4295,0,4,4,0.488372,0,0,0,0
2131,80459F7B,1,3,4,1,0,0,0,0.003312
2132,7DC3BEEA,0,6,6,0.625,0,0,0,0
2133,81391A10,1,2,3,1,0.5,0,0,0.003312
2134,7ACDCA88,1,0,1,0,0,0,0,0.003312
2135,7E2A9B42,10,17,27,0.653846,499.196429,0,0,0.083099
2136,7DAEDFDD,3,0,3,0,0,0,0,0.009935
2137,7E2A53F9,0,1,1,0.5,0,0,0,0
2138,7791C6EA,2,3,5,0.472222,40,0,0,0.032357
2139,751091E4,1,0,1,0,0,0,0,0.003312
2140,7B64F352,2,1,3,1,7,0,0,0.021082
2141,7718D290,1,1,2,1,4,0,0,0.006352
2142,7E3D4EAC,1,0,1,0,0,0,0,0.005241
2143,81435394,0,1,1,0.333333,0,0,0,0
2144,7E544034,16,6,22,0.8,58.9,0.170169,0.184857,0.085366
2145,808F53B9,0,2,2,0.5,0,0,0,0
2146,76310726,1,1,2,1,1,0,0,0.003312
2147,7BB1FB4D,1,0,1,0,0,0,0,0.005241
2148,6E52850E,0,1,1,0.5,0,0,0,0
2149,5BEAF7A2,1,0,1,0,0,0,0,0.005917
2150,759AA5EB,0,2,2,0.75,0,0,0,0
2151,7BCD4B64,1,0,1,0,0,0,0,0.003312
2152,7EEFDB87,1,0,1,0,0,0,0,0.003312
2153,774483BB,0,1,1,0.666667,0,0,0,0
2154,7D88CEC6,1,0,1,0,0,0,0,0.003312
2155,7E26BB2A,2,0,2,0,0,0,0,0.008553
2156,7F06476F,0,2,2,1,0,0,0,0
2157,7B8EFF17,0,2,2,1,0,0,0,0
2158,7EF6189C,1,0,1,0,0,0,0,0.003312
2159,7EA0DD21,4,0,4,0,0,0,0,0.035978
2160,7EB1039D,1,1,2,0.666667,2,0,0,0.003312
2161,78621E4C,1,0,1,0,0,0,0,0.003312
2162,77FA0476,0,3,3,1,0,0,0,0
2163,77C14E88,0,4,4,0.571429,0,0,0,0
2164,76170213,0,2,2,1,0,0,0,0
2165,7DAF6EF3,0,1,1,1,0,0,0,0
2166,6415F89B,0,1,1,1,0,0,0,0
2167,686DDD3C,1,0,1,0,0,0,0,0.003312
2168,5EE4C8B2,0,1,1,1,0,0,0,0
2169,81190C9F,0,3,3,0.8,0,0,0,0
2170,7F1DB672,8,6,14,0.489362,117.392857,0,0,0.034212
2171,7E518AB0,1,2,3,0.5,1,0,0,0.003312
2172,7BE7A1A2,0,1,1,1,0,0,0,0
2173,7CE15532,1,0,1,0,0,0,0,0.007726
2174,789D040A,2,0,2,0,0,0,0,0.019641
2175,7F7C2860,3,1,4,1,2,0,0,0.009935
2176,7AC7181D,1,0,1,0,0,0,0,0.003312
2177,7F70997F,1,0,1,0,0,0,0,0.003312
2178,7CB2E456,0,4,4,1,0,0,0,0
2179,7F27C4B4,1,3,4,0.421053,30,0,0,0.005241
2180,5A74DA0E,0,3,3,0.6,0,0,0,0
2181,80F585C3,0,2,2,0.75,0,0,0,0
2182,85C4B94A,1,0,1,0,0,0,0,0.003312
2183,7CF3D85C,0,2,2,0.384615,0,0,0,0
2184,7FD214BA,0,3,3,0.8,0,0,0,0
2185,800F3AFB,1,0,1,0,0,0,0,0.003312
2186,7733C0EC,3,0,3,0,0,0.000004,0,0.009935
2187,77612016,0,2,2,0.555556,0,0,0,0
2188,7B7A329D,8,0,8,0,0,0,0,0.039181
2189,7C475408,0,2,2,0.288136,0,0,0,0
2190,81534B39,1,0,1,0,0,0,0,0.003312
2191,7C2F71F0,0,2,2,1,0,0,0,0
2192,76C4FC8C,0,2,2,0.247312,0,0,0,0
2193,7CF08B28,0,2,2,1,0,0,0,0
2194,79FBC9B0,2,4,6,0.6,9.47619,0,0,0.008553
2195,78370C83,0,1,1,0.5,0,0,0,0
2196,7792D8C8,1,0,1,0,0,0,0,0.005241
2197,7A45B2E8,1,0,1,0,0,0,0,0.003312
2198,7C354DCB,0,1,1,1,0,0,0,0
2199,813FACAA,1,0,1,0,0,0,0,0.003312
2200,80EC72D2,1,0,1,0,0,0,0,0.003312
2201,80C60D7D,19,0,19,0,0,0,0,0.159735
2202,7DB4A234,1,2,3,1,6,0,0,0.00717
2203,8019242F,0,2,2,0.361111,0,0,0,0
2204,8116EF77,9,1,10,1,21,0.000341,0,0.070802
2205,813E93A9,0,1,1,1,0,0,0,0
2206,7C9A4726,1,1,2,1,0,0,0,0.003312
2207,7EA18BE7,1,0,1,0,0,0,0,0.003312
2208,7EFB3CC6,0,2,2,0.384615,0,0,0,0
2209,76F2F3F2,1,0,1,0,0,0,0,0.01485
2210,809BA5DD,1,1,2,1,1,0,0,0.005241
2211,8179D178,0,2,2,0.545455,0,0,0,0
2212,7DA61B53,0,1,1,1,0,0,0,0
2213,7CCB2FEF,0,3,3,1,0,0,0,0
2214,810E5D33,0,6,6,1,0,0,0,0
2215,7D43B98E,2,0,2,0,0,0.000003,0,0.009108
2216,78A4B0FD,2,0,2,0,0,0,0,0.008553
2217,7866F4BC,1,0,1,0,0,0,0,0.003312
2218,7840DBA4,1,0,1,0,0,0,0,0.003312
2219,7D0B76CA,0,2,2,1,0,0,0,0
2220,799183A1,0,2,2,1,0,0,0,0
2221,7FC2EDEB,5,0,5,0,0,0,0,0.035206
2222,76892DAD,3,2,5,0.583333,14.5,0,0,0.009935
2223,7DD811E2,0,1,1,1,0,0,0,0
2224,81595650,0,5,5,0.366667,0,0,0,0
2225,77871190,0,1,1,1,0,0,0,0
2226,7520D658,0,1,1,1,0,0,0,0
2227,7961BA63,2,0,2,0,0,0,0,0.006624
2228,097008A6,1,0,1,0,0,0,0,0.003312
2229,8014C8DF,0,1,1,1,0,0,0,0
2230,81294DA7,0,1,1,1,0,0,0,0
2231,61F54D03,1,0,1,0,0,0,0,0.003312
2232,70064968,1,0,1,0,0,0,0,0.003312
2233,7C6972AB,0,1,1,1,0,0,0,0
2234,77900563,0,2,2,0.555556,0,0,0,0
2235,7B0CB993,1,0,1,0,0,0,0,0.00717
2236,7ED24D11,0,2,2,0.75,0,0,0,0
2237,7E40EA88,1,0,1,0,0,0,0,0.003312
2238,75C64682,1,2,3,0.75,4.25,0,0,0.010211
2239,769ECAB7,1,0,1,0,0,0,0,0.003312
2240,7E8218B6,1,5,6,0.416667,25,0,0,0.003312
2241,80371498,0,1,1,1,0,0,0,0
2242,79831454,7,0,7,0,0,0,0,0.062015
2243,76ED73D6,1,0,1,0,0,0.002843,0,0.003312
2244,7BB459D9,0,2,2,1,0,0,0,0
2245,80D56619,0,2,2,0.571429,0,0,0,0
2246,7C791742,0,1,1,1,0,0,0,0
2247,80AF31D3,0,1,1,0.454545,0,0,0,0
2248,7E52B075,1,0,1,0,0,0,0,0.00717
2249,80420CE2,1,0,1,0,0,0,0,0.0091
2250,7DFF48A7,1,0,1,0,0,0,0,0.003312
2251,755B7AA8,2,1,3,0.666667,0,0,0,0.008553
2252,80DF1147,2,1,3,1,1,0,0,0.006624
2253,7E8FA888,1,0,1,0,0,0,0,0.003312
2254,7B3E6DF0,0,4,4,0.5,0,0,0,0
2255,799D0076,6,3,9,0.8,44.333333,0,0,0.087462
2256,7D163582,0,2,2,1,0,0,0,0
2257,80C6BE2A,0,3,3,1,0,0,0,0
2258,5B43E9F2,0,1,1,1,0,0,0,0
2259,7914A5A0,1,3,4,0.52381,1.5,0,0.000003,0.003312
2260,80CC814D,1,0,1,0,0,0,0,0.003312
2261,7C86D1FF,5,1,6,1,3,0,0,0.019044
2262,81F85F11,0,1,1,1,0,0,0,0
2263,7B743824,1,1,2,1,1,0,0,0.003312
2264,80BD7765,1,0,1,0,0,0,0,0.003312
2265,7CE90D42,1,0,1,0,0,0,0,0.003312
2266,7AE30ED1,2,1,3,0.6,3,0,0,0.006624
2267,800CE1F9,0,2,2,0.458333,0,0,0,0
2268,80E8096D,0,1,1,1,0,0,0,0
2269,7D43B988,0,2,2,1,0,0,0,0
2270,7EA53826,1,0,1,0,0,0,0,0.003312
2271,8001B02A,2,1,3,0.354839,22,0,0,0.006624
2272,7E032B89,1,1,2,0.666667,1,0,0,0.003312
2273,5DA9FFED,5,0,5,0,0,0,0,0.109959
2274,7E349E11,1,0,1,0,0,0,0,0.003312
2275,776E8AFD,1,0,1,0,0,0,0,0.003312
2276,7BE7E987,1,1,2,1,1,0,0,0.003312
2277,7A1E2A12,0,1,1,1,0,0,0,0
2278,7F0F8BE9,0,3,3,0.571429,0,0,0,0
2279,768E9F3F,0,1,1,1,0,0,0,0
2280,75723138,1,0,1,0,0,0,0,0.003312
2281,7CB98B62,0,1,1,1,0,0,0,0
2282,7C916254,4,0,4,0,0,0,0,0.015176
2283,7ED33BA3,1,0,1,0,0,0,0,0.007726
2284,7E5A3C64,0,3,3,0.8,0,0,0,0
2285,753E09BD,0,4,4,0.565217,0,0,0,0
2286,79BA25C2,0,3,3,1,0,0,0,0
2287,7F5580D0,0,4,4,0.615385,0,0,0,0
2288,7CA4CA29,0,3,3,0.714286,0,0,0,0
2289,5A80A939,1,1,2,1,1,0,0,0.003312
2290,785A83E1,1,0,1,0,0,0,0,0.003312
2291,77F95D37,2,0,2,0,0,0,0,0.008553
2292,7F580629,2,2,4,1,3,0,0,0.006624
2293,593C0D4F,1,0,1,0,0,0,0,0.011585
2294,791F15FD,1,0,1,0,0,0,0,0.018589
2295,81ADC28E,0,1,1,1,0,0,0,0
2296,8135B7EF,0,1,1,1,0,0,0,0
2297,59D93B0F,1,0,1,0,0,0,0,0.003312
2298,76F819D1,2,0,2,0,0,0,0,0.006624
2299,77DEF882,1,12,13,0.462264,13.066667,0,0,0.003312
2300,8048A7B6,0,1,1,1,0,0,0,0
2301,7E66D077,2,0,2,0,0,0,0,0.009664
2302,78A24872,1,5,6,0.727273,6,0,0,0.003312
2303,7A626BCB,0,1,1,1,0,0,0,0
2304,764DCC52,0,1,1,1,0,0,0,0
2305,7EA11138,1,2,3,0.388889,7,0,0,0.003312
2306,8042055B,0,1,1,1,0,0,0,0
2307,7EE1D44A,1,1,2,1,1,0,0,0.003312
2308,7C27FBE2,0,1,1,1,0,0,0,0
2309,7821C8A7,14,3,17,0.472222,124.594841,0,0,0.054082
2310,7E9E12B1,1,0,1,0,0,0,0,0.003312
2311,756669BF,1,0,1,0,0,0,0,0.020588
2312,79F320D1,0,3,3,0.287356,0,0,0,0
2313,802F05F5,1,0,1,0,0,0,0,0.003312
2314,7E30660D,0,1,1,0.5,0,0,0,0
2315,7D9D3E37,0,2,2,0.4375,0,0,0,0
2316,7FB0D373,0,1,1,0.278689,0,0,0,0
2317,7CBDEAA0,2,7,9,0.888889,15,0,0,0.006624
2318,5C84E575,0,5,5,0.555556,0,0,0.000031,0
2319,80D20A88,1,0,1,0,0,0,0,0.003312
2320,77ED1CDE,2,0,2,0,0,0,0,0.014341
2321,755A819F,0,3,3,1,0,0,0,0
2322,751340D3,2,0,2,0,0,0,0,0.006624
2323,7D325C21,1,0,1,0,0,0,0,0.003312
2324,7FB7E1C4,0,1,1,1,0,0,0,0
2325,77BE87D6,0,1,1,1,0,0,0,0
2326,7BDEE90A,0,1,1,1,0,0,0,0
2327,79CE46B2,0,1,1,0.333333,0,0,0,0
2328,78F857C6,0,2,2,0.75,0,0,0,0
2329,7C62A1FC,0,3,3,1,0,0,0,0
2330,7D475029,0,1,1,1,0,0,0,0
2331,76FB3DC2,0,1,1,1,0,0,0,0
2332,640A4251,0,13,13,0.571429,0,0,0,0
2333,79397861,4,0,4,0,0,0,0,0.024005
2334,7CDBEE66,1,0,1,0,0,0,0,0.003312
2335,75BB60D3,1,0,1,0,0,0,0,0.007726
2336,83068CD3,1,0,1,0,0,0,0,0.017215
2337,75FE6168,4,8,12,1,17.333333,0.059782,0.139303,0.01959
2338,7823E317,0,3,3,0.397059,0,0,0.08725,0
2339,70470A55,1,0,1,0,0,0,0,0.010766
2340,2DDAA7D9,2,0,2,0,0,0,0,0.006624
2341,76555F97,5,3,8,0.448276,34.416667,0,0,0.026866
2342,757D2720,3,1,4,1,4,0.000004,0,0.011865
2343,7B8F8E87,1,1,2,1,1,0,0,0.003312
2344,78027E14,1,0,1,0,0,0,0,0.007726
2345,80C07EB6,2,0,2,0,0,0,0,0.043143
2346,8140D29F,0,1,1,1,0,0,0,0
2347,5A32B663,0,2,2,0.555556,0,0,0,0
2348,5DB9ACA2,4,1,5,1,4,0,0,0.017106
2349,80D88CEB,2,0,2,0,0,0,0,0.031944
2350,7BCC9647,1,0,1,0,0,0,0,0.003312
2351,76C4CBD4,1,0,1,0,0,0,0,0.003312
2352,7F5675F0,3,0,3,0,0,0,0,0.014349
2353,7F0904B8,0,1,1,1,0,0,0.000001,0
2354,7E5D1B94,1,0,1,0,0,0,0,0.003312
2355,7A5D8E7A,2,0,2,0,0,0,0,0.008553
2356,7A387B89,1,0,1,0,0,0,0,0.003312
2357,801D3A2E,0,1,1,1,0,0,0,0
2358,813D375D,0,1,1,1,0,0,0,0
2359,2E6D6870,1,0,1,0,0,0,0,0.003312
2360,7B68D329,1,1,2,1,1,0,0,0.003312
2361,7C98EE07,0,1,1,1,0,0,0,0
2362,75F24A1C,1,0,1,0,0,0,0,0.003312
2363,7DFFBAA8,1,0,1,0,0,0,0,0.003312
2364,7F544EA8,1,0,1,0,0,0,0,0.003312
2365,7ECA6316,0,1,1,1,0,0,0,0
2366,7ACF9D25,0,1,1,1,0,0,0,0
2367,7A591054,1,0,1,0,0,0,0,0.003312
2368,7665C0F9,1,0,1,0,0,0,0,0.003312
2369,76F67F8B,0,1,1,1,0,0,0,0
2370,80B1AC3B,2,2,4,1,3.5,0,0,0.008553
2371,79895810,0,1,1,1,0,0,0,0
2372,7EAF8AA5,0,2,2,1,0,0,0,0
2373,77517660,0,1,1,1,0,0,0,0
2374,76176656,1,3,4,0.463415,9,0,0,0.003312
2375,5FAF68AB,1,0,1,0,0,0,0,0.003312
2376,76E31AD1,2,0,2,0,0,0,0,0.021637
2377,78E40285,1,0,1,0,0,0,0,0.003312
2378,7C2A9EB0,1,0,1,0,0,0,0,0.003312
2379,757BDA45,1,0,1,0,0,0,0,0.003312
2380,79E4CB23,1,0,1,0,0,0,0,0.003312
2381,809E0202,0,8,8,0.833333,0,0,0,0
2382,7DEC1EB8,2,0,2,0,0,0,0,0.008553
2383,7A9D02E8,0,1,1,1,0,0,0,0
2384,77971272,1,0,1,0,0,0,0,0.003312
2385,7DCE5344,2,0,2,0,0,0,0,0.006624
2386,013871E8,3,0,3,0,0,0.000013,0,0.051989
2387,7D0E2649,0,5,5,0.432099,0,0,0,0
2388,7A461AFA,0,1,1,1,0,0,0,0
2389,78896FCC,0,1,1,1,0,0,0,0
2390,783A9326,0,1,1,1,0,0,0.001499,0
2391,03539DDD,1,0,1,0,0,0,0,0.003312
2392,78677E93,1,0,1,0,0,0,0,0.007726
2393,80652AF8,0,2,2,0.466667,0,0,0,0
2394,7F80E1F7,0,1,1,1,0,0,0,0
2395,7F7C4CF4,0,2,2,0.365854,0,0,0,0
2396,75D2DD10,1,0,1,0,0,0,0,0.003312
2397,7D3D691F,1,0,1,0,0,0,0,0.0091
2398,78CAD826,1,3,4,1,3,0,0,0.003312
2399,7C881624,1,1,2,0.32,1.333333,0,0,0.003312
2400,7C44A925,1,0,1,0,0,0,0,0.003312
2401,7A1D67A1,0,2,2,0.75,0,0,0,0
2402,7E7F4B15,1,1,2,1,1,0,0,0.003312
2403,5B652F7A,0,1,1,1,0,0,0,0
2404,780D4CA8,1,0,1,0,0,0,0,0.003312
2405,80B7B2E9,1,0,1,0,0,0,0,0.003312
2406,814C78FE,0,1,1,0.6,0,0,0,0
2407,7B24C2FF,8,0,8,0,0,0,0,0.039842
2408,61372A7F,2,0,2,0,0,0,0,0.006624
2409,7432CE58,1,0,1,0,0,0,0,0.003312
2410,7FAB0156,2,0,2,0,0,0,0,0.012148
2411,79621518,2,0,2,0,0,0,0,0.006624
2412,77B080D8,7,0,7,0,0,0,0,0.048477
2413,7E23C4B9,0,1,1,1,0,0,0,0
2414,79CAD408,1,0,1,0,0,0,0,0.005241
2415,7CEEB33B,2,6,8,0.5,20.788095,0,0,0.009108
2416,79239387,1,2,3,0.75,1,0,0,0.003312
2417,59B759E3,1,0,1,0,0,0,0,0.003312
2418,81369940,0,5,5,0.777778,0,0,0,0
2419,7BFFC7C1,1,0,1,0,0,0,0,0.003312
2420,7EC15CA6,0,6,6,0.422222,0,0,0,0
2421,7A15BFEC,1,1,2,1,0,0,0,0.005241
2422,7D246DC5,0,3,3,0.344828,0,0,0,0
2423,7EAA02D4,1,1,2,1,1,0,0,0.003312
2424,7D6888F8,1,0,1,0,0,0,0,0.003312
2425,7A4AD230,2,0,2,0,0,0,0,0.008553
2426,77022302,1,0,1,0,0,0,0,0.003312
2427,7EA5D79C,1,0,1,0,0,0,0,0.003312
2428,76310277,2,1,3,1,2,0,0,0.006624
2429,7D9B9612,0,1,1,1,0,0,0,0
2430,77D33E1C,1,0,1,0,0,0,0,0.005241
2431,7F9919CD,0,1,1,0.340909,0,0,0,0
2432,80AACC98,0,1,1,0.428571,0,0,0,0
2433,7D6A605B,4,4,8,0.75,20.833333,0,0,0.015176
2434,7703D582,5,0,5,0,0,0.064424,0,0.031836
2435,78B280BD,0,1,1,0.666667,0,0,0,0
2436,7B6B6180,0,1,1,0.666667,0,0,0,0
2437,838299BC,4,3,7,1,21,0,0,0.021256
2438,7B7B2BB2,2,3,5,1,4.5,0,0.000037,0.008553
2439,815445AC,0,1,1,1,0,0,0,0
2440,7E039B0F,1,1,2,0.666667,0,0,0,0.003312
2441,7815F76F,2,0,2,0,0,0,0,0.006624
2442,786187BB,0,3,3,0.454545,0,0,0,0
2443,7F1E5CCC,0,1,1,1,0,0,0,0
2444,7DE917BD,1,1,2,0.538462,14,0,0,0.005241
2445,7ED337D2,0,3,3,0.291667,0,0,0,0
2446,6E26987C,0,2,2,0.75,0,0,0,0
2447,80DFD9C4,0,6,6,0.875,0,0,0,0
2448,7E184A60,1,1,2,1,0,0,0,0.003312
2449,79099B77,0,1,1,1,0,0,0,0
2450,77987FA2,5,0,5,0,0,0,0,0.03062
2451,7AB23739,1,2,3,0.470588,7,0.010259,0.038186,0.005796
2452,7D8E8C9D,1,0,1,0,0,0,0,0.003312
2453,09DE6A8B,35,0,35,0,0,0,0,0.28952
2454,7DA2D38A,0,6,6,0.358491,0,0,0,0
2455,762BB639,1,2,3,1,2,0,0,0.003312
2456,7DA969D8,3,0,3,0,0,0,0,0.011865
2457,7D26C9AC,0,1,1,0.666667,0,0,0,0
2458,7F680C64,1,0,1,0,0,0,0,0.003312
2459,7CDEDA47,2,0,2,0,0,0,0,0.010482
2460,7ABDFBE7,3,2,5,0.555556,13.833333,0,0,0.029258
2461,7DC324E3,1,0,1,0,0,0,0,0.003312
2462,7F67FA3E,0,2,2,0.538462,0,0,0.000001,0
2463,7800576A,1,3,4,0.416667,9.166667,0,0,0.016817
2464,7BEB2920,1,0,1,0,0,0,0,0.003312
2465,751D0FB5,0,2,2,1,0,0,0,0
2466,79E17330,1,0,1,0,0,0,0,0.003312
2467,77234953,3,2,5,1,10,0,0,0.019979
2468,7DA5B8DD,1,1,2,1,1,0,0,0.003312
2469,77BD74A4,0,1,1,1,0,0,0,0
2470,7FE4C7B7,1,0,1,0,0,0,0,0.005902
2471,804D7867,0,1,1,1,0,0,0,0
2472,7745AB97,0,1,1,1,0,0,0,0
2473,75EF6B4E,0,1,1,0.414286,0,0,0,0
2474,75256BAB,3,0,3,0,0,0,0,0.009935
2475,815DA420,0,5,5,0.482759,0,0,0,0
2476,7729A262,1,0,1,0,0,0,0,0.006352
2477,7B89DCAD,0,1,1,1,0,0,0,0
2478,79070439,0,1,1,0.6,0,0,0,0
2479,7F171260,0,3,3,0.545455,0,0,0,0
2480,7B281178,1,0,1,0,0,0,0,0.003312
2481,80F014FC,0,4,4,0.434783,0,0,0,0
2482,0B9174FA,0,4,4,0.5,0,0,0.123542,0
2483,7DAC0101,1,0,1,0,0,0,0,0.003312
2484,7B0DBB20,1,2,3,0.75,3,0,0,0.003312
2485,800B0BBD,0,1,1,0.666667,0,0,0,0
2486,79D3F950,10,5,15,1,93,0.000142,0.000004,0.07903
2487,59204C90,0,6,6,0.65,0,0,0.164484,0
2488,8143A6A5,1,0,1,0,0,0,0,0.003312
2489,7E56A222,0,2,2,1,0,0,0,0
2490,812DFE13,0,2,2,1,0,0,0,0
2491,8166F49B,1,1,2,1,0,0,0,0.003312
2492,7F576BF7,0,1,1,1,0,0,0,0
2493,7FD4A425,0,2,2,1,0,0,0,0
2494,7786C74F,1,2,3,0.75,3,0,0.000001,0.003312
2495,5B391881,0,1,1,1,0,0,0,0
2496,77B6E949,0,2,2,1,0,0,0,0
2497,61928747,0,1,1,1,0,0,0,0
2498,7D7C0E14,4,1,5,1,7,0,0,0.020251
2499,7CEE89D2,1,1,2,1,32.5,0,0,0.038055
2500,7DC1DB47,1,0,1,0,0,0,0,0.003312
2501,7813B22A,1,1,2,1,3.5,0,0,0.0091
2502,7569BA42,1,3,4,1,2.5,0.009831,0.033697,0.003312
2503,7C4D38D8,6,0,6,0,0,0.00001,0,0.039456
2504,77020370,1,0,1,0,0,0,0,0.005241
2505,804C200D,0,6,6,0.351351,0,0,0,0
2506,795FC266,1,1,2,1,0,0,0,0.007726
2507,7F4D2EE5,1,1,2,1,1,0,0,0.003312
2508,5E9B6086,0,2,2,0.571429,0,0,0,0
2509,7D2403BC,3,10,13,0.459016,51.333333,0,0,0.009935
2510,7BB32244,0,4,4,0.421569,0,0,0,0
2511,77CCDAB0,0,1,1,1,0,0,0,0
2512,7B0228A1,1,0,1,0,0,0,0,0.003312
2513,79E70120,1,1,2,1,1,0,0,0.003312
2514,7A3D94C3,0,1,1,1,0,0,0,0
2515,755273FC,0,2,2,0.482759,0,0,0,0
2516,75918CBB,1,1,2,1,1,0,0,0.003312
2517,5DE38A49,1,0,1,0,0,0,0,0.003312
2518,14E02A8E,2,0,2,0,0,0,0,0.027902
2519,7B9C5B7E,1,0,1,0,0,0,0,0.003312
2520,77CDA935,1,0,1,0,0,0,0,0.003312
2521,7ADC9AB2,1,0,1,0,0,0,0,0.003312
2522,763F7993,2,0,2,0,0,0,0,0.006624
2523,78D7A037,1,0,1,0,0,0,0,0.005241
2524,7DDAC5E8,0,1,1,0.375,0,0,0,0
2525,7A1A892A,1,0,1,0,0,0,0,0.003312
2526,78085EE6,0,3,3,0.45,0,0,0,0
2527,7A01C0A4,0,1,1,1,0,0,0,0
2528,19A5BBDE,0,1,1,1,0,0,0,0
2529,782B2EBB,0,1,1,1,0,0,0,0
2530,7C68F292,1,0,1,0,0,0,0,0.003312
2531,76365BA2,2,0,2,0,0,0,0,0.006624
2532,78CDD104,1,0,1,0,0,0,0,0.003312
2533,79ED4E7E,1,0,1,0,0,0,0,0.009129
2534,7D04A8F3,4,0,4,0,0,0,0,0.017106
2535,7F8E46E6,3,1,4,1,1,0,0,0.016279
2536,7D7B9502,1,1,2,1,1,0,0,0.003312
2537,7AE5DC68,1,0,1,0,0,0,0,0.003312
2538,7E108389,0,2,2,0.368421,0,0,0,0
2539,0F2430F1,0,1,1,0.3,0,0,0,0
2540,76894952,0,2,2,1,0,0,0,0
2541,77560FEE,2,0,2,0,0,0,0,0.006624
2542,7513B789,2,1,3,1,2,0,0,0.006624
2543,8053DDA5,0,1,1,1,0,0,0,0
2544,7E4B1EBA,0,5,5,1,0,0,0,0
2545,756DB671,1,0,1,0,0,0,0,0.005241
2546,801484F4,0,2,2,1,0,0,0,0
2547,7A431578,0,1,1,1,0,0,0,0
2548,81625640,4,3,7,0.36,33.166667,0,0,0.019035
2549,80783FFF,2,0,2,0,0,0,0,0.008553
2550,80336EC0,0,3,3,1,0,0,0,0
2551,776E2144,0,1,1,1,0,0,0,0
2552,75EF7A3A,1,0,1,0,0,0,0,0.003312
2553,7FD93F34,0,1,1,1,0,0,0,0
2554,755DBA93,0,2,2,1,0,0,0,0
2555,7A32C9CE,0,2,2,0.666667,0,0,0,0
2556,782D69CC,2,1,3,0.666667,18,0,0,0.020129
2557,7D76B388,5,0,5,0,0,0,0,0.025942
2558,7AF2516B,2,0,2,0,0,0,0,0.006624
2559,7A35A018,1,0,1,0,0,0,0,0.003312
2560,7E5475A9,1,6,7,0.611111,11,0,0,0.003312
2561,00CAC36F,0,2,2,0.583333,0,0,0,0
2562,7C2CC706,3,0,3,0,0,0,0,0.009935
2563,76F98BA9,1,0,1,0,0,0,0,0.003312
2564,7A9A03C0,2,4,6,0.6,14.941667,0,0,0.012412
2565,75728B14,4,2,6,0.482759,41.033333,0,0,0.013247
2566,80C21AB4,11,5,16,0.777778,114.833333,0,0,0.063574
2567,793FECA6,1,0,1,0,0,0,0,0.010573
2568,796E4FC2,0,1,1,0.454545,0,0,0,0
2569,80E3338B,2,1,3,1,3,0,0,0.008553
2570,79E90323,0,1,1,1,0,0,0,0
2571,761F67C7,1,0,1,0,0,0,0,0.003312
2572,794E3E76,2,0,2,0,0,0,0,0.006624
2573,7975D1F2,1,0,1,0,0,0,0,0.003312
2574,7F2ABB0E,2,0,2,0,0,0,0,0.039121
2575,7ED9ABD4,1,0,1,0,0,0,0,0.009655
2576,75FF52F4,8,3,11,0.533333,72.095238,0,0,0.032282
2577,799E7A00,1,0,1,0,0,0,0,0.003312
2578,780BADDC,0,1,1,1,0,0,0,0
2579,7B9F9343,0,2,2,1,0,0,0,0
2580,7E36A154,0,1,1,1,0,0,0,0
2581,7D313487,3,0,3,0,0,0,0,0.011865
2582,7FA13545,1,2,3,0.75,0,0,0,0.005241
2583,7A153812,0,2,2,1,0,0,0,0
2584,8023933F,0,2,2,1,0,0,0,0
2585,63E619BF,0,1,1,1,0,0,0,0
2586,7D386C69,0,1,1,0.5,0,0,0,0
2587,7622C089,1,0,1,0,0,0,0,0.003312
2588,7E720588,1,1,2,0.5,0,0,0,0.005241
2589,801F4DB9,0,1,1,0.666667,0,0,0,0
2590,78C99975,0,1,1,0.545455,0,0,0.053363,0
2591,7EBF95B0,1,1,2,0.4,0,0,0,0.016817
2592,78D3F37B,1,0,1,0,0,0,0,0.003312
2593,7EAADF30,1,0,1,0,0,0,0,0.003312
2594,7B818939,1,0,1,0,0,0,0,0.003312
2595,7D2DA075,0,1,1,1,0,0,0,0
2596,77C0B800,5,2,7,1,16,0,0,0.020973
2597,7CD8D50B,1,0,1,0,0,0,0,0.003312
2598,61E4B914,1,0,1,0,0,0,0,0.003312
2599,81BDA21E,1,0,1,0,0,0,0,0.011585
2600,7B5B7D7D,2,0,2,0,0,0,0,0.008553
2601,6CE78652,0,1,1,0.666667,0,0,0,0
2602,7F9DA5C8,1,0,1,0,0,0,0,0.003312
2603,80B0D4D0,1,10,11,0.568182,41.5,0,0,0.005241
2604,7B7D7808,1,0,1,0,0,0,0,0.003312
2605,8119C739,0,1,1,1,0,0,0,0
2606,7F62499C,3,6,9,0.421053,10.666667,0,0,0.013794
2607,7E3B2001,0,2,2,0.35443,0,0,0,0
2608,7B33E9DB,1,0,1,0,0,0,0,0.003312
2609,7DEAE029,0,4,4,1,0,0,0,0
2610,7F8B020D,3,0,3,0,0,0,0,0.009935
2611,7A7E067C,1,0,1,0,0,0.004717,0,0.003312
2612,7A97F9F7,14,0,14,0,0,0,0,0.11597
2613,807875DB,1,0,1,0,0,0,0,0.003312
2614,0455851D,0,1,1,1,0,0,0,0
2615,7658B717,1,0,1,0,0,0,0,0.007726
2616,7EB61725,0,3,3,1,0,0,0,0
2617,7D7BD8EC,1,0,1,0,0,0,0,0.003312
2618,0646D146,14,2,16,1,418,0,0,0.354223
2619,785D7CC1,1,4,5,0.833333,2,0,0,0.003312
2620,7655FF0B,1,1,2,0.375,0,0,0,0.003312
2621,7BEA6836,0,2,2,1,0,0,0,0
2622,076F5C0F,4,0,4,0,0,0,0,0.069797
2623,5ACE155B,1,3,4,0.478261,6.5,0,0,0.003312
2624,7F7743B8,4,0,4,0,0,0,0,0.028419
2625,7E9B9C7E,1,0,1,0,0,0,0,0.003312
2626,81D8BD6C,0,2,2,1,0,0,0,0
2627,76C7391E,0,2,2,0.666667,0,0,0,0
2628,0205CBD9,0,1,1,1,0,0,0,0
2629,7CA9AD5F,1,0,1,0,0,0,0,0.003312
2630,7E30714D,0,3,3,0.714286,0,0,0,0
2631,7C0AF3AE,1,0,1,0,0,0,0,0.003312
2632,7FBDB0C9,0,4,4,0.533333,0,0,0,0
2633,798EE2E3,0,1,1,0.6,0,0,0,0
2634,798DC4E4,1,0,1,0,0,0,0,0.003312
2635,7D2497FC,3,4,7,0.571429,62.5,0,0,0.020099
2636,7F89E8C8,2,0,2,0,0,0,0,0.018913
2637,7A3013CE,1,0,1,0,0,0,0,0.003312
2638,755BF026,0,2,2,1,0,0,0,0
2639,7BCCEB4D,1,4,5,1,2,0,0,0.003312
2640,75E5710C,0,1,1,1,0,0,0,0
2641,5D9985BF,1,0,1,0,0,0,0,0.003312
2642,636DA984,2,0,2,0,0,0,0,0.008553
2643,7D40275A,4,2,6,0.75,15,0,0,0.020146
2644,7E9FDC74,1,0,1,0,0,0,0,0.003312
2645,7DD7E90A,3,0,3,0,0,0,0,0.01242
2646,236A363D,0,3,3,1,0,0,0.080361,0
2647,5DFD2E36,2,0,2,0,0,0,0,0.012412
2648,75C6EC0D,1,0,1,0,0,0,0,0.003312
2649,7EE1C3BD,4,0,4,0,0,0.000004,0,0.019538
2650,7D30C389,0,1,1,1,0,0,0,0
2651,75910518,1,0,1,0,0,0,0,0.003312
2652,7B684AB0,4,3,7,1,11.333333,0,0,0.018877
2653,80D27C84,0,2,2,0.666667,0,0,0,0
2654,79C91E24,15,0,15,0,0,0,0,0.484401
2655,7F49AC1E,2,3,5,0.8,12,0,0,0.008553
2656,7F87AA22,1,1,2,1,1,0,0,0.003312
2657,7C0D5F04,2,0,2,0,0,0,0,0.016826
2658,7D64FA13,0,1,1,1,0,0,0,0
2659,7C2240C5,1,0,1,0,0,0,0,0.003312
2660,789E719F,2,0,2,0,0,0,0,0.008553
2661,7D3FDA7F,2,1,3,0.5,6,0,0,0.006624
2662,806B5F8F,0,3,3,1,0,0,0,0
2663,7B260EDD,1,0,1,0,0,0,0,0.003312
2664,7ECECD7C,0,1,1,1,0,0,0,0
2665,77625197,2,0,2,0,0,0,0,0.006624
2666,76723409,0,1,1,1,0,0,0,0
2667,7AE6AD25,0,2,2,0.411765,0,0,0,0
2668,795678A0,1,0,1,0,0,0,0,0.003312
2669,753949B0,0,1,1,1,0,0,0,0
2670,76D2826A,1,0,1,0,0,0,0,0.003312
2671,803D60D6,1,2,3,0.295775,5,0,0,0.011029
2672,78D2B344,1,0,1,0,0,0,0,0.003312
2673,7DE935CE,0,1,1,1,0,0,0,0
2674,75944D70,3,0,3,0,0,0,0,0.020693
2675,7DB579BA,3,0,3,0,0,0,0,0.009935
2676,762ACA46,0,1,1,1,0,0,0,0
2677,7F5D9EA9,0,1,1,0.414286,0,0,0,0
2678,7B70EC99,0,1,1,0.666667,0,0,0,0
2679,77DF0E7A,1,0,1,0,0,0,0,0.003312
2680,796041A0,0,1,1,0.5,0,0,0,0
2681,75A5851C,0,5,5,0.315789,0,0,0,0
2682,7F3C9BEB,1,0,1,0,0,0,0,0.003312
2683,7C817E8D,3,0,3,0,0,0,0,0.025767
2684,7A81F2B3,1,0,1,0,0,0,0,0.005241
2685,7576AC99,0,1,1,1,0,0,0,0
2686,78348442,0,1,1,1,0,0,0,0
2687,75F06F3E,1,0,1,0,0,0,0,0.003312
2688,61EC0D62,1,0,1,0,0,0,0,0.003312
2689,77957703,1,0,1,0,0,0,0,0.003312
2690,75E7E719,1,0,1,0,0,0,0,0.005796
2691,78AF6DAF,1,0,1,0,0,0,0,0.003312
2692,7E6D2DA9,0,1,1,1,0,0,0,0
2693,766205DF,5,0,5,0,0,0,0,0.03432
2694,7B151618,7,2,9,0.425,67,0,0,0.098206
2695,7B3D64EC,0,1,1,1,0,0,0,0
2696,78F8A965,0,7,7,1,0,0,0,0
2697,78EC64D4,0,2,2,0.47619,0,0,0.060279,0
2698,8079384F,2,0,2,0,0,0,0,0.006624
2699,7EAD1D26,0,1,1,1,0,0,0,0
2700,7F3F79EA,0,1,1,1,0,0,0,0
2701,084D852C,1,0,1,0,0,0.009311,0,0.005241
2702,75475DAE,2,0,2,0,0,0,0,0.006624
2703,79CE0C37,1,0,1,0,0,0,0,0.003312
2704,7B6B4EBE,1,0,1,0,0,0,0,0.003312
2705,7870732C,0,7,7,0.534884,0,0,0.095636,0
2706,7717B1F5,1,0,1,0,0,0,0,0.003312
2707,757A7943,1,0,1,0,0,0,0,0.003312
2708,80A77AF2,1,0,1,0,0,0,0,0.003312
2709,7BFF2B9F,0,3,3,0.555556,0,0,0.035935,0
2710,7EB1D319,2,0,2,0,0,0,0,0.010482
2711,7C97D731,0,1,1,1,0,0,0,0
2712,764C81B3,2,0,2,0,0,0,0,0.008553
2713,7E5A5396,19,5,24,0.571429,207.957143,0,0,0.143449
2714,7BDC4B1A,1,0,1,0,0,0.021919,0,0.003312
2715,7FAD9A90,0,2,2,1,0,0,0,0
2716,788E2CA6,0,1,1,1,0,0,0,0
2717,7D8BA1F2,2,0,2,0,0,0,0,0.039007
2718,79361C90,2,0,2,0,0,0,0,0.006624
2719,76B6CF4C,1,0,1,0,0,0,0,0.005241
2720,7BDF037E,0,4,4,1,0,0,0,0
2721,11B57531,1,0,1,0,0,0,0,0.005241
2722,6031122B,1,0,1,0,0,0,0,0.003312
2723,71EB4920,2,0,2,0,0,0,0,0.008553
2724,760C0B48,1,1,2,0.666667,2,0,0,0.003312
2725,7EAE1CC0,2,0,2,0,0,0,0,0.010482
2726,7CA093F3,1,0,1,0,0,0,0,0.003312
2727,58C22955,1,0,1,0,0,0,0,0.003312
2728,814359DF,0,5,5,0.357143,0,0,0,0
2729,7C7168B3,1,0,1,0,0,0,0,0.003312
2730,75BC842A,1,0,1,0,0,0,0,0.005241
2731,61FEB075,1,0,1,0,0,0,0,0.003312
2732,7C3F703F,0,4,4,0.541667,0,0,0,0
2733,7F30E423,3,9,12,0.465649,122.269048,0,0,0.009935
2734,7EC52E15,7,0,7,0,0,0,0,0.0522
2735,81141285,1,0,1,0,0,0,0,0.003312
2736,5EBB10C6,1,0,1,0,0,0,0,0.003312
2737,7F923B05,1,4,5,0.833333,10,0,0,0.005241
2738,768F5766,2,1,3,0.5,0,0,0,0.006624
2739,7FD3DA28,0,1,1,1,0,0,0,0
2740,7D814398,3,3,6,0.714286,12,0,0,0.009935
2741,76692021,1,0,1,0,0,0,0,0.003312
2742,80C20E6B,1,2,3,0.75,3,0,0,0.003312
2743,77542143,1,0,1,0,0,0.019201,0,0.014174
2744,7EA25978,0,1,1,1,0,0,0,0
2745,754ADB4B,1,1,2,1,1,0,0,0.003312
2746,7789AB8F,1,1,2,0.5,0,0,0,0.003312
2747,768C0B98,4,6,10,0.75,41.666667,0.076285,0.155511,0.031009
2748,7833CE96,0,1,1,0.322222,0,0,0,0
2749,768DE11A,0,1,1,1,0,0,0,0
2750,73F65F14,1,0,1,0,0,0,0,0.003312
2751,75353F7C,0,2,2,0.428571,0,0,0,0
2752,78248D40,0,1,1,1,0,0,0,0
2753,7BFCC99E,1,2,3,1,1,0,0,0.003312
2754,759BF1E8,1,0,1,0,0,0,0,0.003312
2755,8106F774,4,0,4,0,0,0,0,0.025379
2756,77C56461,2,0,2,0,0,0,0,0.017712
2757,76462778,2,6,8,0.8,20.5,0,0,0.008553
2758,7B99A166,0,1,1,1,0,0,0,0
2759,77EBEA44,3,1,4,1,2.75,0.024139,0.032988,0.020777
2760,7CFE7A3E,1,3,4,0.6,0.533333,0.02085,0.116626,0.003312
2761,7623D032,0,1,1,0.304348,0,0,0,0
2762,7E8B1AC7,0,1,1,1,0,0,0,0
2763,7D56E824,0,2,2,0.362069,0,0,0,0
2764,7FE1AC87,0,2,2,1,0,0,0,0
2765,7EF611F4,3,0,3,0,0,0.000002,0,0.011865
2766,76227ABC,0,2,2,0.75,0,0,0,0
2767,7D035998,1,1,2,0.454545,4,0,0,0.005241
2768,751FE120,1,4,5,0.75,12,0,0,0.005241
2769,8070B056,0,2,2,0.75,0,0,0,0
2770,7D89999E,1,5,6,0.47619,3.5,0,0,0.003312
2771,7F979318,0,2,2,0.5,0,0,0.003029,0
2772,77C8EECB,0,5,5,0.538462,0,0,0,0
2773,78B73B43,0,1,1,1,0,0,0,0
2774,7680A85E,1,0,1,0,0,0,0,0.005241
2775,5CD7CC84,1,0,1,0,0,0,0,0.0091
2776,7E41474B,1,0,1,0,0,0,0,0.003312
2777,6F034A3F,1,0,1,0,0,0,0,0.003312
2778,75151F15,3,0,3,0,0,0,0,0.023441
2779,753B753E,0,3,3,1,0,0,0,0
2780,80C080E6,1,0,1,0,0,0,0,0.003312
2781,758CD9CF,1,0,1,0,0,0,0,0.003312
2782,77B26F2E,0,1,1,1,0,0,0,0
2783,7722344A,2,1,3,1,1,0,0,0.006624
2784,7F701AE0,0,4,4,0.636364,0,0,0,0
2785,792C94A1,0,1,1,1,0,0,0,0
2786,75B71771,1,0,1,0,0,0,0,0.003312
2787,7BBB6656,2,1,3,0.571429,0.25,0.027488,0.018145,0.021345
2788,7D9250C9,1,0,1,0,0,0,0,0.005241
2789,7ADB119B,0,6,6,0.5625,0,0,0,0
2790,78129EAD,0,1,1,1,0,0,0,0
2791,7A524ABE,0,1,1,1,0,0,0,0
2792,7D4DEC55,1,0,1,0,0,0,0,0.003312
2793,8100892F,5,0,5,0,0,0,0,0.053462
2794,7681FD6D,2,0,2,0,0,0,0,0.011038
2795,818C4131,0,1,1,1,0,0,0,0
2796,771B62B5,3,0,3,0,0,0,0,0.123515
2797,7AACB6EC,1,0,1,0,0,0,0,0.003312
2798,7AF91039,1,0,1,0,0,0,0,0.003312
2799,7DF8898E,0,1,1,0.666667,0,0,0,0
2800,7FB22FDF,0,1,1,1,0,0,0,0
2801,00BA30E4,1,4,5,0.75,6,0,0.072315,0.003312
2802,7BD8768D,3,0,3,0,0,0,0,0.013794
2803,7B1BD4AB,0,3,3,1,0,0,0,0
2804,7F2F253B,1,2,3,0.434783,18,0,0,0.005796
2805,81672ED3,1,0,1,0,0,0,0,0.005241
2806,78F28AC4,0,1,1,1,0,0,0,0
2807,7ECCE810,0,2,2,1,0,0,0,0
2808,7AEA0AD6,1,0,1,0,0,0,0,0.005241
2809,7F26D1A5,1,1,2,0.5,0,0,0,0.00717
2810,7590732B,0,1,1,1,0,0,0,0
2811,5C002145,0,4,4,0.354167,0,0,0,0
2812,7B9596C5,1,0,1,0,0,0,0,0.003312
2813,81684A2B,1,0,1,0,0,0,0,0.003312
2814,04C0E48B,1,0,1,0,0,0,0,0.003312
2815,7EB1A1BD,1,0,1,0,0,0,0,0.003312
2816,7ACB91C0,0,2,2,0.75,0,0,0,0
2817,75CF50DD,1,1,2,0.5,3,0,0,0.003312
2818,771449FE,1,0,1,0,0,0,0,0.003312
2819,77F15C47,2,0,2,0,0,0,0,0.006624
2820,7EB0ADE1,0,2,2,1,0,0,0,0
2821,7B490882,1,1,2,1,1,0,0,0.003312
2822,79E783BD,0,1,1,1,0,0,0,0
2823,78182F31,1,0,1,0,0,0,0,0.003312
2824,5A85E443,2,0,2,0,0,0,0,0.006624
2825,5C9E3AF4,1,1,2,0.666667,2,0,0,0.003312
2826,5E62A949,1,0,1,0,0,0,0,0.003312
2827,7AED9C22,0,2,2,0.5,0,0,0,0
2828,7684DEEC,0,3,3,0.615385,0,0,0,0
2829,767C548A,2,5,7,0.44898,25.666667,0,0,0.008553
2830,7EBE8F6C,1,0,1,0,0,0,0,0.003312
2831,63E78259,1,0,1,0,0,0,0,0.003312
2832,766A1873,1,0,1,0,0,0,0,0.003312
2833,78F16575,3,0,3,0,0,0,0,0.016279
2834,759C6137,0,1,1,1,0,0,0,0
2835,76926EA6,1,0,1,0,0,0,0,0.00717
2836,7B75BA11,1,0,1,0,0,0,0,0.003312
2837,7EA5FE5C,0,1,1,1,0,0,0,0
2838,7BB62E94,3,0,3,0,0,0,0,0.017495
2839,7E44F694,3,1,4,1,3,0,0,0.011865
2840,7EC2E20A,1,0,1,0,0,0,0,0.006352
2841,2E82C939,0,1,1,1,0,0,0,0
2842,788719A8,2,0,2,0,0,0,0,0.008553
2843,80B18FA4,2,0,2,0,0,0,0,0.012412
2844,80032AC7,1,2,3,1,0.5,0,0,0.003312
2845,7B6674C0,3,1,4,0.666667,40,0,0,0.074845
2846,804DE928,7,4,11,0.625,120,0,0,0.051146
2847,780DBCAC,0,2,2,1,0,0,0,0
2848,7FBE8D25,0,2,2,0.75,0,0,0,0
2849,7E88A35F,0,1,1,1,0,0,0,0
2850,06D1169D,1,0,1,0,0,0,0,0.003312
2851,80A23FEC,1,0,1,0,0,0,0,0.003312
2852,7E867D6B,1,0,1,0,0,0,0,0.003312
2853,0310D7DD,1,0,1,0,0,0,0,0.003312
2854,7813A3BC,0,1,1,1,0,0,0,0
2855,7E671D8D,1,0,1,0,0,0,0,0.005241
2856,7CEA8089,0,1,1,1,0,0,0,0
2857,77046791,1,2,3,0.342857,8,0,0,0.005241
2858,75ADF4D3,3,0,3,0,0,0,0,0.013794
2859,801F21C0,0,3,3,0.714286,0,0,0,0
2860,75643C12,0,1,1,0.6,0,0,0,0
2861,7BB135A5,0,6,6,0.512195,0,0,0,0
2862,7F8D7076,0,9,9,0.722222,0,0,0,0
2863,79E0A8AC,0,1,1,1,0,0,0,0
2864,815BE76F,0,1,1,1,0,0,0,0
2865,7E89DCF1,1,3,4,0.414634,15,0,0,0.003312
2866,7CB69D2D,1,0,1,0,0,0,0,0.003312
2867,7A6D8445,0,4,4,0.615385,0,0,0,0
2868,7580FF17,1,0,1,0,0,0,0,0.003312
2869,7F6C6110,1,3,4,0.393939,1,0,0,0.003312
2870,80939E5F,0,2,2,0.347826,0,0,0,0
2871,7D677A7E,9,0,9,0,0,0.000016,0,0.073844
2872,810E2C40,0,1,1,1,0,0,0,0
2873,8287F6BA,3,2,5,1,12,0,0,0.018763
2874,79843819,12,0,12,0,0,0,0,0.06772
2875,79EE302A,0,1,1,1,0,0,0,0
2876,7E99A57D,2,0,2,0,0,0,0,0.010482
2877,795AC33F,1,0,1,0,0,0,0,0.008281
2878,769EF080,0,1,1,0.666667,0,0,0,0
2879,810046BD,0,1,1,0.666667,0,0,0,0
2880,7E00CAAC,0,1,1,1,0,0,0,0
2881,7CA23455,1,0,1,0,0,0,0,0.005902
2882,7DBC6833,2,2,4,1,6.5,0,0,0.012412
2883,79B13E20,1,0,1,0,0,0,0,0.003312
2884,5D3B8A7D,1,0,1,0,0,0,0,0.003312
2885,80762F87,0,2,2,0.5,0,0,0,0
2886,754F715F,5,0,5,0,0,0.054057,0,0.031836
2887,7D197169,12,0,12,0,0,0,0,0.292952
2888,7CD9BAA1,0,2,2,1,0,0,0,0
2889,815546CA,4,3,7,0.571429,77.333333,0,0,0.027705
2890,5A086CC5,0,4,4,0.571429,0,0,0,0
2891,7CE26336,0,1,1,0.198276,0,0,0,0
2892,5C935A3D,0,5,5,0.515152,0,0,0,0
2893,02A99FAC,2,0,2,0,0,0,0,0.006624
2894,797EF901,4,0,4,0,0,0,0,0.031406
2895,7705E189,1,1,2,1,1,0,0,0.003312
2896,7F25226C,1,1,2,1,1,0,0,0.003312
2897,7EA58C25,0,2,2,1,0,0,0,0
2898,7DF81663,0,2,2,1,0,0,0,0
2899,7DC562AC,2,1,3,1,1,0,0,0.006624
2900,7E26A35A,1,0,1,0,0,0,0,0.003312
2901,7D672EB6,1,0,1,0,0,0,0,0.003312
2902,59F1C270,1,0,1,0,0,0,0,0.003312
2903,7DD73241,0,2,2,0.315789,0,0,0,0
2904,81E36BC6,0,1,1,1,0,0,0,0
2905,8136C9F3,0,1,1,1,0,0,0,0
2906,79C8FEE0,0,1,1,1,0,0,0,0
2907,762E4322,0,1,1,0.5,0,0,0,0
2908,5FCC07BF,0,1,1,0.6,0,0,0,0
2909,7847C5EC,1,7,8,0.6,30,0,0.101048,0.005241
2910,803CA5F2,1,1,2,0.410256,0,0,0,0.027115
2911,7E835A5D,0,3,3,0.8,0,0,0,0
2912,08242D1C,1,0,1,0,0,0,0,0.005241
2913,7A3F8EAE,0,1,1,0.311828,0,0,0,0
2914,757B2E70,0,2,2,0.470588,0,0,0,0
2915,7D5FBAC0,0,2,2,1,0,0,0,0
2916,7FD20F0D,3,2,5,1,7,0,0,0.011865
2917,7FED7A6D,6,7,13,0.684211,72.333333,0.007223,0.000056,0.023729
2918,79D468AB,1,1,2,0.666667,2,0,0,0.003312
2919,7BA5B409,0,4,4,0.7,0,0,0.119298,0
2920,78BA1E78,0,1,1,1,0,0,0,0
2921,7C36606E,0,3,3,1,0,0,0,0
2922,7FB9E349,1,0,1,0,0,0,0,0.003312
2923,59FFEDA0,1,0,1,0,0,0,0,0.003312
2924,7C171B84,2,0,2,0,0,0,0,0.014896
2925,7A50E5B2,1,1,2,1,1,0,0,0.003312
2926,79422512,1,0,1,0,0,0,0,0.003312
2927,64007285,1,0,1,0,0,0,0,0.003312
2928,80EEB676,0,1,1,1,0,0,0,0
2929,80035B00,0,1,1,1,0,0,0,0
2930,5ADA19F8,2,0,2,0,0,0,0,0.025654
2931,7EE5B8DF,0,1,1,0.38,0,0,0,0
2932,8578CFB7,1,0,1,0,0,0,0,0.003312
2933,7C383F76,2,0,2,0,0,0,0,0.006624
2934,799B08B3,0,1,1,1,0,0,0,0
2935,494AFFA5,5,0,5,0,0,0,0,0.029246
2936,78B85F5B,0,1,1,0.666667,0,0,0,0
2937,7CA0A52A,0,5,5,0.608696,0,0,0.078815,0
2938,7919D4AA,0,1,1,1,0,0,0,0
2939,7FD2D902,3,2,5,1,22,0,0,0.028478
2940,756E8E3C,1,0,1,0,0,0,0,0.003312
2941,7DE50972,0,1,1,1,0,0,0,0
2942,7E9E2F44,0,1,1,1,0,0,0,0
2943,81689AE9,2,4,6,1,8,0,0,0.006624
2944,7F273C70,2,4,6,0.833333,7.5,0,0,0.006624
2945,7A561E51,2,0,2,0,0,0,0,0.006624
2946,7E88D609,0,1,1,0.318182,0,0,0,0
2947,7CC55C24,2,0,2,0,0,0,0,0.013411
2948,7BDA8F56,1,0,1,0,0,0,0,0.003312
2949,7E967906,0,1,1,1,0,0,0,0
2950,7A0E2CD5,2,2,4,0.36,0.7,0,0,0.025946
2951,7563C047,1,0,1,0,0,0,0,0.003312
2952,7885722A,0,4,4,0.833333,0,0,0,0
2953,7CCE1EAB,0,1,1,0.473684,0,0,0,0
2954,809726F8,0,3,3,1,0,0,0,0
2955,7CD338E8,3,0,3,0,0,0,0,0.009935
2956,76D02C40,1,0,1,0,0,0,0,0.003312
2957,7CF17995,1,2,3,0.75,3,0,0,0.003312
2958,7918E185,2,1,3,1,6,0,0,0.017936
2959,7A4C1C24,0,1,1,1,0,0,0,0
2960,7B62F514,1,1,2,1,0,0,0,0.003312
2961,76A21171,2,0,2,0,0,0,0,0.006624
2962,80BD18BD,0,1,1,0.45,0,0,0,0
2963,76682872,1,0,1,0,0,0,0,0.038822
2964,79C87CAF,0,3,3,0.636364,0,0,0,0
2965,7D3B8C10,1,3,4,0.466667,12,0,0,0.003312
2966,7D44E95E,1,2,3,0.666667,0,0,0,0.003312
2967,029BC18B,2,0,2,0,0,0,0,0.010482
2968,7E11BA61,0,4,4,1,0,0,0,0
2969,7EAAA9B8,1,0,1,0,0,0,0,0.003312
2970,811C45ED,2,2,4,0.538462,3.666667,0,0,0.006624
2971,7A976E3C,0,1,1,1,0,0,0,0
2972,78062883,0,1,1,0.4,0,0,0,0
2973,7F834894,11,0,11,0,0,0.000002,0,0.065136
2974,7EDC2888,1,0,1,0,0,0,0,0.003312
2975,7889F064,1,2,3,1,1,0,0,0.003312
2976,7E479717,0,3,3,0.538462,0,0,0,0
2977,804AFFC8,0,2,2,0.454545,0,0,0,0
2978,7DD17A02,4,2,6,1,5,0,0,0.015176
2979,80E1C763,0,2,2,0.75,0,0,0,0
2980,7DA18AAA,23,0,23,0,0,0,0,0.246951
2981,7FEB5E3C,1,0,1,0,0,0,0,0.005241
2982,77D70EE8,3,1,4,1,0.5,0,0,0.016279
2983,7F299FF7,0,1,1,1,0,0,0,0
2984,7A16C701,0,3,3,1,0,0,0,0
2985,80C18A97,3,0,3,0,0,0,0,0.024551
2986,81379A04,1,0,1,0,0,0,0,0.003312
2987,757BA9D2,1,0,1,0,0,0,0,0.003312
2988,77A1A3F8,0,1,1,1,0,0,0,0
2989,7F3AD6EA,0,1,1,0.5,0,0,0,0
2990,7DE1F448,0,1,1,1,0,0,0,0
2991,80864C39,1,0,1,0,0,0,0,0.003312
2992,7E5F4C46,1,2,3,0.433333,13,0,0,0.003312
2993,7C5E85D4,0,2,2,1,0,0,0,0
2994,7A26E3DB,1,0,1,0,0,0,0,0.003312
2995,7C745053,3,1,4,1,1.5,0,0,0.018208
2996,77BB7315,0,2,2,0.5625,0,0,0.070639,0
2997,77A06383,0,1,1,1,0,0,0,0
2998,7FAD88DD,0,2,2,1,0,0,0,0
2999,7CC99570,0,3,3,1,0,0,0,0
3000,804FFAD3,0,1,1,0.5,0,0,0,0
3001,7F93FD5D,1,0,1,0,0,0,0,0.003312
3002,75D8976B,1,4,5,0.533333,21.5,0,0,0.009129
3003,7F74363D,0,1,1,1,0,0,0,0
3004,7EFBD745,5,0,5,0,0,0,0,0.063292
3005,76A250A3,0,1,1,1,0,0,0,0
3006,7ACD76E7,1,0,1,0,0,0,0,0.003312
3007,77164952,2,2,4,1,1,0,0,0.011038
3008,7CE90107,1,2,3,0.461538,3.5,0,0,0.016817
3009,63831551,0,1,1,0.4,0,0,0,0
3010,78383755,1,0,1,0,0,0,0,0.003312
3011,7BF91632,0,1,1,1,0,0,0,0
3012,7C84EE7F,0,1,1,0.666667,0,0,0,0
3013,7E19AB94,0,1,1,1,0,0,0,0
3014,7B3F6A95,1,0,1,0,0,0,0,0.003312
3015,75C2C0F0,1,2,3,0.391304,9,0,0,0.003312
3016,77A7FE00,1,1,2,1,1,0,0,0.003312
3017,79458A33,1,0,1,0,0,0,0,0.003312
3018,7693EC9E,1,0,1,0,0,0,0,0.003312
3019,59C5CE15,1,0,1,0,0,0,0,0.00976
3020,78B152A6,0,5,5,0.777778,0,0,0,0
3021,78FE7DF6,0,2,2,0.625,0,0,0,0
3022,7EA23110,1,0,1,0,0,0,0,0.003312
3023,7B80CF03,0,1,1,0.30303,0,0,0,0
3024,7E6F39F7,0,1,1,0.4,0,0,0,0
3025,7DF80D5B,0,1,1,0.6,0,0,0,0
3026,79BD242E,1,0,1,0,0,0,0,0.003312
3027,7D289251,4,1,5,0.454545,41.666667,0,0,0.028576
3028,7C3E824D,0,2,2,1,0,0,0,0
3029,7D1F6772,0,2,2,0.414634,0,0,0,0
3030,7BF14BDE,3,1,4,1,3,0,0,0.009935
3031,7E9A5B6E,1,0,1,0,0,0,0,0.003312
3032,74AC4F16,0,1,1,1,0,0,0,0
3033,77DC73D4,2,6,8,0.875,11.5,0,0,0.008553
3034,801DDCDE,0,1,1,1,0,0,0,0
3035,753E3DB0,2,0,2,0,0,0,0,0.011038
3036,7BAF3A51,1,1,2,0.666667,6,0,0,0.00717
3037,7690EEC2,0,1,1,1,0,0,0,0
3038,7E0A5A6A,1,0,1,0,0,0,0,0.003312
3039,7FF6CD2C,1,0,1,0,0,0,0,0.003312
3040,76466C41,1,0,1,0,0,0,0,0.003312
3041,7B20988D,1,0,1,0,0,0,0,0.005241
3042,60684407,1,0,1,0,0,0,0,0.007726
3043,76CFB370,1,0,1,0,0,0,0,0.005241
3044,81154444,1,6,7,1,6,0,0,0.003312
3045,7788EA16,1,0,1,0,0,0,0,0.003312
3046,77FCC1CD,0,2,2,0.571429,0,0,0,0
3047,815D0157,0,2,2,0.75,0,0,0,0
3048,79EB3534,2,0,2,0,0,0,0,0.006624
3049,75372F15,0,1,1,0.666667,0,0,0,0
3050,78BA3DFC,0,4,4,0.7,0,0,0,0
3051,806DCF5D,0,1,1,1,0,0,0,0
3052,7817A896,6,0,6,0,0,0.000007,0,0.032002
3053,7D97A2F1,0,2,2,1,0,0,0,0
3054,7E137376,0,1,1,0.666667,0,0,0,0
3055,75A12F00,1,0,1,0,0,0,0,0.005796
3056,7F7C46DD,1,0,1,0,0,0,0,0.003312
3057,76B3DEA6,1,0,1,0,0,0,0,0.003312
3058,7CCA444F,0,2,2,0.375,0,0,0,0
3059,7DBCED11,1,0,1,0,0,0,0,0.003312
3060,7C2C5876,0,1,1,0.5,0,0,0,0
3061,7C8FFB43,1,0,1,0,0,0,0,0.003312
3062,7F978705,0,5,5,0.56,0,0,0,0
3063,7DD3D46D,1,0,1,0,0,0,0,0.003312
3064,77BAC83A,0,1,1,1,0,0,0,0
3065,8031C1A0,1,2,3,0.5,30,0,0,0.00717
3066,7A86717D,0,1,1,1,0,0,0,0
3067,7FB094F8,1,1,2,0.571429,4,0,0,0.003312
3068,80C0C8FF,0,1,1,0.666667,0,0,0,0
3069,593D6F79,1,0,1,0,0,0,0,0.003312
3070,7AE99EC5,1,0,1,0,0,0,0,0.003312
3071,765A0F63,0,4,4,0.75,0,0,0,0
3072,7A11402A,1,5,6,0.588235,9,0,0,0.003312
3073,7C821CD8,4,0,4,0,0,0,0,0.015176
3074,7C2433CC,2,0,2,0,0,0.000007,0,0.008553
3075,7D813A2E,0,1,1,1,0,0,0,0
3076,7A50251C,1,0,1,0,0,0,0,0.003312
3077,7C17BBA0,1,0,1,0,0,0,0,0.003312
3078,80965E53,0,1,1,1,0,0,0,0
3079,7EB76B55,0,1,1,0.5,0,0,0,0
3080,75282E16,0,1,1,1,0,0,0,0
3081,7F4F3786,0,1,1,1,0,0,0,0
3082,7BE12DB2,1,0,1,0,0,0,0,0.003312
3083,7E62167A,1,1,2,0.375,27,0,0,0.00717
3084,0A160420,1,0,1,0,0,0,0,0.016817
3085,7F024451,0,1,1,1,0,0,0,0
3086,7E8B42A3,15,2,17,0.392857,357.833333,0,0,0.159172
3087,7D993692,3,1,4,1,3.5,0,0,0.015723
3088,79C4DC08,1,0,1,0,0,0,0,0.003312
3089,7B743EF8,1,0,1,0,0,0,0,0.003312
3090,78038821,0,1,1,1,0,0,0,0
3091,7F3CC4F9,0,2,2,0.666667,0,0,0,0
3092,7874B10A,1,0,1,0,0,0,0,0.003312
3093,7D9C0559,2,6,8,0.615385,30,0,0,0.006624
3094,76F98E19,0,1,1,1,0,0,0,0
3095,7E5A6DEB,1,1,2,1,1,0,0,0.003312
3096,77EFCDE2,1,2,3,1,2,0,0,0.003312
3097,7C014410,1,0,1,0,0,0,0,0.003312
3098,80C7769D,0,1,1,1,0,0,0,0
3099,7E2EA7D0,0,1,1,0.368421,0,0,0,0
3100,7817E7DB,1,0,1,0,0,0.000003,0,0.003312
3101,7C03F9FA,1,0,1,0,0,0,0,0.029032
3102,77FB802A,0,3,3,0.4375,0,0,0.002752,0
3103,792740A0,1,0,1,0,0,0,0,0.003312
3104,78154A3F,0,4,4,0.529412,0,0,0,0
3105,79F600F8,1,1,2,1,0,0,0,0.003312
3106,7D53093B,1,1,2,0.5,5,0,0,0.003312
3107,757A5932,0,1,1,0.444444,0,0,0,0
3108,7D9AC1A6,0,1,1,1,0,0,0,0
3109,75B42683,6,0,6,0,0,0,0,0.034434
3110,7A94BCA9,0,1,1,1,0,0,0,0
3111,7FF820DF,1,0,1,0,0,0,0,0.003312
3112,81586C0C,0,3,3,0.333333,0,0,0,0
3113,7ED8BCF4,1,0,1,0,0,0,0,0.003312
3114,7C363B38,1,4,5,0.6,2,0,0,0.003312
3115,806F249C,1,0,1,0,0,0,0,0.003312
3116,605E8A00,0,1,1,1,0,0,0,0
3117,76420520,4,3,7,0.583333,29.85,0,0,0.101565
3118,777209AC,1,0,1,0,0,0,0,0.003312
3119,7A4F1BF1,1,0,1,0,0,0,0,0.003312
3120,7595FC97,0,1,1,0.666667,0,0,0,0
3121,7B45C027,1,4,5,0.37037,2.833333,0,0,0.003312
3122,7E524867,0,2,2,1,0,0,0,0
3123,7EC2A175,0,1,1,1,0,0,0,0
3124,8064B721,1,5,6,1,4,0,0,0.003312
3125,7D2DE954,0,1,1,0.666667,0,0,0,0
3126,79578200,1,0,1,0,0,0,0,0.00717
3127,7606B316,1,0,1,0,0,0,0,0.003312
3128,7C02666C,1,0,1,0,0,0,0,0.003312
3129,7DE18991,0,3,3,1,0,0,0,0
3130,780D68C7,1,0,1,0,0,0,0,0.003312
3131,7E237409,2,1,3,0.416667,5,0,0,0.020129
3132,7E978AD9,0,1,1,1,0,0,0,0
3133,7C9EA03B,1,2,3,1,2,0,0,0.003312
3134,7B8BE660,1,1,2,1,1,0,0,0.003312
3135,7E49FD26,6,1,7,1,17,0,0,0.06639
3136,7E1DE163,0,1,1,1,0,0,0,0
3137,7A382AF2,1,0,1,0,0,0,0,0.003312
3138,75167634,1,0,1,0,0,0,0,0.003312
3139,7929F35E,0,1,1,1,0,0,0,0
3140,7D814652,1,3,4,0.451613,4,0,0,0.003312
3141,07C8FF15,1,0,1,0,0,0,0,0.003312
3142,75D70534,1,0,1,0,0,0,0,0.003312
3143,6415F370,1,0,1,0,0,0,0,0.003312
3144,7B06AD4E,0,2,2,0.75,0,0,0,0
3145,601AB8E7,1,0,1,0,0,0,0,0.003312
3146,77C70F27,0,1,1,1,0,0,0,0
3147,7880EE9A,1,0,1,0,0,0,0,0.005241
3148,7EBE6B6C,0,2,2,0.75,0,0,0,0
3149,7BCEA5EE,0,1,1,1,0,0,0,0
3150,7986EE1C,0,3,3,0.5,0,0,0,0
3151,7F57D7A6,0,4,4,0.833333,0,0,0,0
3152,7B39699B,2,0,2,0,0,0,0,0.008553
3153,77AC63E0,1,2,3,0.75,3,0,0,0.003312
3154,7E9D7482,1,0,1,0,0,0,0,0.003312
3155,7A99ABBC,1,0,1,0,0,0,0,0.003312
3156,7E799C36,0,1,1,1,0,0,0,0
3157,77332995,1,0,1,0,0,0,0,0.00717
3158,75F1B59A,0,1,1,1,0,0,0,0
3159,80BB8C79,0,5,5,0.588235,0,0,0,0
3160,7F98FDFE,0,2,2,1,0,0,0,0
3161,26C491F1,1,0,1,0,0,0,0,0.003312
3162,7F9D8056,2,7,9,0.769231,20,0,0,0.006624
3163,78164ACF,0,5,5,0.313725,0,0,0,0
3164,7B1254EB,1,13,14,0.666667,22,0,0,0.003312
3165,7673D10F,0,2,2,1,0,0,0,0
3166,79613A71,1,0,1,0,0,0,0,0.00717
3167,76909A91,0,2,2,0.521739,0,0,0.018115,0
3168,7EA86BA5,0,1,1,1,0,0,0,0
3169,81043D0F,1,0,1,0,0,0,0,0.003312
3170,7CA7F599,0,1,1,0.375,0,0,0,0
3171,7F597628,0,1,1,0.666667,0,0,0,0
3172,75D45563,1,0,1,0,0,0,0,0.008056
3173,795869A4,1,10,11,0.537037,14.166667,0,0,0.005241
3174,7F903A7F,0,1,1,0.538462,0,0,0,0
3175,7E6D4F08,0,1,1,1,0,0,0,0
3176,7B0AA3BC,0,3,3,0.625,0,0,0,0
3177,80E0066F,1,0,1,0,0,0,0,0.003312
3178,75EC789B,0,5,5,1,0,0,0,0
3179,7802E64A,1,0,1,0,0,0,0,0.003312
3180,26208A6C,0,5,5,0.555556,0,0,0.094264,0
3181,7DCFD29F,1,8,9,0.536585,21,0,0,0.003312
3182,81305D6E,1,0,1,0,0,0,0,0.003312
3183,85F0A857,3,0,3,0,0,0.000008,0,0.033882
3184,81D7B375,11,2,13,0.75,43.166667,0,0,0.062622
3185,7E64114A,0,2,2,1,0,0,0,0
3186,7E7A0947,1,0,1,0,0,0,0,0.003312
3187,7AEF1DFC,1,0,1,0,0,0,0,0.003312
3188,80027911,3,0,3,0,0,0,0,0.021856
3189,78B341CB,0,7,7,0.6875,0,0,0,0
3190,8100C8ED,8,2,10,1,16.333333,0,0,0.03268
3191,63A01266,0,1,1,0.666667,0,0,0,0
3192,7D465BEB,1,5,6,1,4,0,0,0.003312
3193,815E9C3B,0,1,1,0.5,0,0,0,0
3194,80E8687D,1,3,4,0.392857,24.5,0,0,0.003312
3195,7FCFE4FF,1,3,4,1,2,0,0,0.003312
3196,77CDDAB7,7,0,7,0,0,0,0,0.025112
3197,78E8BC6E,0,1,1,1,0,0,0,0
3198,75D05925,1,0,1,0,0,0,0,0.003312
3199,7F0E3699,0,1,1,0.363636,0,0,0,0
3200,755E95EF,1,0,1,0,0,0,0,0.003312
3201,7EFA7B82,1,0,1,0,0,0,0,0.013476
3202,7898736D,0,1,1,1,0,0,0,0
3203,5C351B28,0,1,1,1,0,0,0,0
3204,7C08980A,0,1,1,1,0,0,0,0
3205,7E81E78E,0,1,1,0.461538,0,0,0,0
3206,7F8E2B3E,1,2,3,0.5,18,0,0,0.005241
3207,76B3572C,0,4,4,0.403846,0,0,0,0
3208,79BBF729,0,1,1,1,0,0,0,0
3209,75DD1BAA,1,0,1,0,0,0,0,0.003312
3210,77943E70,0,1,1,1,0,0,0,0
3211,8036F836,1,0,1,0,0,0,0,0.003312
3212,7EC5CE1F,5,0,5,0,0,0,0,0.032683
3213,7551F804,2,2,4,1,1,0,0,0.006624
3214,8120D1BC,0,2,2,1,0,0,0,0
3215,7FDB75A3,1,2,3,0.666667,3,0,0,0.003312
3216,7EFF0006,2,0,2,0,0,0,0,0.006624
3217,799E8DAB,0,2,2,1,0,0,0,0
3218,791F850D,8,3,11,0.555556,29.516667,0,0,0.094912
3219,7B89D9B9,1,0,1,0,0,0,0,0.003312
3220,7DDF3489,2,0,2,0,0,0,0,0.010482
3221,7BF762F0,1,1,2,0.6,8,0,0,0.009655
3222,76D98A64,5,0,5,0,0,0.000324,0,0.035589
3223,81127BA2,2,1,3,1,1,0,0,0.008553
3224,78802B63,1,0,1,0,0,0,0,0.003312
3225,7F85DF16,2,0,2,0,0,0,0,0.006624
3226,79C8D63E,2,0,2,0,0,0,0,0.006624
3227,61010E4A,5,0,5,0,0,0,0,0.037586
3228,797FE8E7,0,2,2,0.555556,0,0,0,0
3229,7961C288,1,0,1,0,0,0,0,0.005241
3230,77591035,0,2,2,1,0,0,0,0
3231,77FD46E1,0,1,1,1,0,0,0,0
3232,8174598C,0,1,1,1,0,0,0,0
3233,7DD932F7,1,0,1,0,0,0,0,0.003312
3234,7628DF97,0,2,2,1,0,0,0,0
3235,7A26CF21,6,0,6,0,0,0,0,0.024285
3236,59658F63,3,1,4,1,6,0,0,0.017653
3237,7F50C53B,0,1,1,1,0,0,0,0
3238,7C55B02D,2,0,2,0,0,0,0,0.006624
3239,7BBED213,0,3,3,0.8,0,0,0,0
3240,7638DBA5,0,13,13,0.46729,0,0,0,0
3241,7FBAF5DD,1,0,1,0,0,0,0,0.003312
3242,81F999E7,1,2,3,0.75,12,0,0,0.00976
3243,7F76C0AB,0,1,1,0.666667,0,0,0,0
3244,81550D31,1,0,1,0,0,0,0,0.007726
3245,7E6D0A30,0,3,3,0.48,0,0,0,0
3246,81645F6C,1,0,1,0,0,0,0,0.003312
3247,7D4D4A13,2,0,2,0,0,0,0,0.03241
3248,815201F1,1,0,1,0,0,0,0,0.008281
3249,7CADC3C2,2,0,2,0,0,0,0,0.013411
3250,79D8EF65,1,0,1,0,0,0.000155,0,0.003312
3251,5B44AC59,8,0,8,0,0,0,0,0.034504
3252,7E3A8968,1,0,1,0,0,0,0,0.005241
3253,7894566E,0,3,3,1,0,0,0,0
3254,78D74B4E,1,0,1,0,0,0,0,0.003312
3255,784E4150,0,4,4,1,0,0,0,0
3256,7F566DA7,0,1,1,0.666667,0,0,0,0
3257,8014D1C1,0,1,1,1,0,0,0,0
3258,7AF1A68C,0,1,1,1,0,0,0,0
3259,7596F743,2,0,2,0,0,0,0,0.019152
3260,7FFC0123,0,1,1,1,0,0,0,0
3261,80D0E1A0,1,0,1,0,0,0,0,0.003312
3262,80DA0FFE,0,1,1,1,0,0,0,0
3263,7D4905FF,0,2,2,1,0,0,0,0
3264,8053557E,1,0,1,0,0,0,0,0.003312
3265,757E2E22,0,4,4,0.333333,0,0,0,0
3266,7DD682D1,1,0,1,0,0,0.000155,0,0.003312
3267,7A8936FF,0,1,1,0.545455,0,0,0.053363,0
3268,7C9840A5,1,0,1,0,0,0,0,0.036236
3269,7A04C0D4,1,1,2,0.454545,3.5,0,0,0.003312
3270,79AE870F,1,0,1,0,0,0,0,0.017215
3271,7A2B4188,0,1,1,1,0,0,0,0
3272,813B12CD,3,1,4,1,0.5,0,0,0.013794
3273,7EABB3E6,1,2,3,1,8,0,0,0.005902
3274,7EB05172,2,0,2,0,0,0,0,0.006624
3275,7F741167,12,1,13,1,8.5,0,0,0.060145
3276,7E4FB2E4,0,3,3,0.714286,0,0,0,0
3277,76FBF866,1,0,1,0,0,0,0,0.003312
3278,7F7F40BE,1,0,1,0,0,0,0,0.003312
3279,7D9CCE12,7,0,7,0,0,0.000019,0,0.108163
3280,814394CB,0,1,1,1,0,0,0,0
3281,7EDB626C,0,1,1,0.666667,0,0,0,0
3282,7FA49D4E,0,1,1,0.666667,0,0,0,0
3283,7F2B3618,4,2,6,0.28169,39,0,0,0.017106
3284,7C8E1E44,3,1,4,1,5,0,0,0.016279
3285,7FC8B8C7,5,0,5,0,0,0,0,0.039042
3286,76BEB085,0,1,1,1,0,0,0,0
3287,79FB3892,0,1,1,1,0,0,0,0
3288,80E796C6,0,1,1,0.454545,0,0,0,0
3289,7A0E1085,0,8,8,0.45614,0,0,0,0
3290,7D1C9709,1,0,1,0,0,0,0,0.003312
3291,811F6D4D,0,1,1,0.5,0,0,0,0
3292,7D1359E0,1,1,2,1,2,0,0,0.005241
3293,7DAB687C,2,1,3,1,2,0,0,0.006624
3294,5D90884F,0,3,3,0.625,0,0,0,0
3295,77FA89E0,1,0,1,0,0,0,0,0.003312
3296,584F084E,1,0,1,0,0,0,0,0.003312
3297,7F2D87A7,0,1,1,1,0,0,0,0
3298,7D25B7B2,0,1,1,0.444444,0,0,0,0
3299,7F706E8E,0,2,2,1,0,0,0,0
3300,7D969FA2,0,4,4,0.464286,0,0,0,0
3301,7EF9181E,0,2,2,0.666667,0,0,0,0
3302,7E935570,1,1,2,1,1,0,0,0.003312
3303,7E703BA5,0,7,7,0.769231,0,0,0,0
3304,7FD31463,0,1,1,1,0,0,0,0
3305,75C26648,0,1,1,1,0,0,0,0
3306,7E373374,1,1,2,0.5,0,0,0,0.003312
3307,774821A3,1,0,1,0,0,0,0,0.005241
3308,80FF1110,0,2,2,1,0,0,0,0
3309,78EAAAFA,2,1,3,0.375,8,0,0,0.008553
3310,8003875B,0,1,1,1,0,0,0,0
3311,80B121C0,1,0,1,0,0,0,0,0.003312
3312,7A52F8F7,1,0,1,0,0,0,0,0.003312
3313,5BB76AF2,1,0,1,0,0,0,0,0.003312
3314,7C0B050D,0,1,1,1,0,0,0,0
3315,75230CB4,2,0,2,0,0,0,0,0.010482
3316,7E5C4A91,0,3,3,0.416667,0,0,0,0
3317,803D2EA9,1,0,1,0,0,0,0,0.003312
3318,7F50CEBF,0,1,1,1,0,0,0,0
3319,7CE71917,1,0,1,0,0,0,0,0.003312
3320,7BD7A66F,2,1,3,0.666667,1,0,0,0.010482
3321,7AFA3DB4,0,1,1,0.310345,0,0,0,0
3322,7C9504D1,4,2,6,1,6.5,0,0,0.015176
3323,76F43FF8,2,0,2,0,0,0,0,0.012967
3324,80C33AF5,0,1,1,1,0,0,0,0
3325,7E6B0B14,2,2,4,1,4,0,0,0.006624
3326,7ED63F1D,2,1,3,1,2,0,0,0.006624
3327,7E48907A,0,1,1,1,0,0,0,0
3328,80A4F768,0,2,2,0.666667,0,0,0,0
3329,7264C26A,1,0,1,0,0,0,0,0.005241
3330,7E2CCD73,3,0,3,0,0,0,0,0.016279
3331,77659AC7,0,1,1,1,0,0,0.005488,0
3332,0999B943,0,1,1,0.36,0,0,0,0
3333,7F64D04E,0,3,3,0.6,0,0,0,0
3334,799371AC,1,0,1,0,0,0,0,0.003312
3335,7C4F0B32,1,0,1,0,0,0,0,0.003312
3336,7959F955,2,0,2,0,0,0,0,0.008553
3337,782ACD82,1,3,4,0.615385,7,0,0.000016,0.003312
3338,7BC504DD,1,0,1,0,0,0,0,0.003312
3339,7F9D0572,4,0,4,0,0,0,0,0.025379
3340,754B8E04,1,0,1,0,0,0,0,0.003312
3341,7E7074C5,0,1,1,0.666667,0,0,0,0
3342,766E8ABB,2,0,2,0,0,0,0,0.008553
3343,7147D9A7,1,0,1,0,0,0,0,0.003312
3344,80F38EF1,2,3,5,1,13.666667,0,0,0.020129
3345,7E4F2CB2,0,1,1,1,0,0,0,0
3346,7ECA249E,0,1,1,1,0,0,0,0
3347,79809269,0,1,1,1,0,0,0,0
3348,81C8B805,0,3,3,0.8,0,0,0,0
3349,807C5926,1,0,1,0,0,0,0,0.003312
3350,80A2C522,0,1,1,0.666667,0,0,0,0
3351,7FCE13ED,1,0,1,0,0,0,0,0.005241
3352,7D07B75D,0,5,5,0.576923,0,0,0,0
3353,77B3C097,0,1,1,1,0,0,0,0
3354,7DFC3DC3,6,7,13,0.818182,32.083333,0.029529,0.194789,0.022355
3355,7D44E1DC,0,1,1,0.545455,0,0,0.053363,0
3356,5AF47D2F,6,1,7,1,22,0,0,0.062795
3357,7E5B56E2,2,0,2,0,0,0,0,0.006624
3358,80900D69,0,1,1,1,0,0,0,0
3359,00DD6F36,1,0,1,0,0,0,0,0.003312
3360,635F25C6,0,1,1,1,0,0,0,0
3361,7EF95C73,0,5,5,0.461538,0,0,0,0
3362,7F5C56F2,0,2,2,1,0,0,0,0
3363,04C1F644,1,0,1,0,0,0,0,0.005241
3364,79E40A8B,1,2,3,0.75,0,0,0,0.003312
3365,76635AD8,0,2,2,1,0,0,0,0
3366,7706FF01,1,0,1,0,0,0,0,0.003312
3367,7F50BE74,1,1,2,1,1,0,0,0.003312
3368,5F729CC4,0,3,3,0.478261,0,0,0,0
3369,761A0575,0,1,1,1,0,0,0,0
3370,806CA32B,0,8,8,1,0,0,0,0
3371,79D50713,0,1,1,1,0,0,0,0
3372,615A7267,1,0,1,0,0,0,0,0.011532
3373,786A4F6B,1,1,2,1,1,0,0,0.003312
3374,7ED3F4B6,1,0,1,0,0,0,0,0.003312
3375,7E7A6268,0,1,1,0.666667,0,0,0,0
3376,7A57246D,7,0,7,0,0,0,0,0.028152
3377,7B1E3C1C,0,1,1,1,0,0,0,0
3378,80576996,0,1,1,0.666667,0,0,0,0
3379,7D27C6B6,0,4,4,0.833333,0,0,0,0
3380,7C9E844F,0,4,4,0.833333,0,0,0,0
3381,7B0721F5,1,0,1,0,0,0,0,0.003312
3382,7A388303,0,3,3,0.636364,0,0,0,0
3383,79EB601B,1,0,1,0,0,0,0,0.003312
3384,817A4D71,6,1,7,1,1,0,0,0.023729
3385,7FF4B987,0,2,2,1,0,0,0,0
3386,7C483F36,1,0,1,0,0,0,0,0.005241
3387,7F5D2A79,1,0,1,0,0,0,0,0.005241
3388,80C4AD11,1,0,1,0,0,0,0,0.003312
3389,62F7F2E3,1,0,1,0,0,0,0,0.005241
3390,760F5A4D,1,0,1,0,0,0,0,0.003312
3391,7A30AF75,0,1,1,1,0,0,0,0
3392,7F21D9E8,4,6,10,0.8,31,0,0,0.015176
3393,789DD010,0,2,2,1,0,0,0,0
3394,80FBD71A,2,0,2,0,0,0.000078,0,0.008553
3395,78635524,0,1,1,1,0,0,0,0
3396,64291CA6,1,0,1,0,0,0,0,0.003312
3397,61655808,0,3,3,1,0,0,0,0
3398,7CA604DB,0,2,2,1,0,0,0,0
3399,80618C34,0,1,1,1,0,0,0,0
3400,7F5ED1BB,1,2,3,0.545455,0,0,0,0.003312
3401,75CBC7E2,1,0,1,0,0,0,0,0.003312
3402,7CAC750E,1,0,1,0,0,0,0,0.003312
3403,7DFCE7E7,2,0,2,0,0,0,0,0.006624
3404,79485D1E,2,0,2,0,0,0,0,0.006624
3405,5B8C4E07,1,0,1,0,0,0,0,0.003312
3406,7E33E303,0,1,1,0.545455,0,0,0,0
3407,7E62F934,4,2,6,0.583333,27,0,0,0.015176
3408,7C65238C,1,0,1,0,0,0,0,0.003312
3409,7B908CA1,5,0,5,0,0,0,0,0.034981
3410,7831EC9E,1,2,3,0.5625,5,0,0,0.003312
3411,7989A7A3,2,0,2,0,0,0,0,0.006624
3412,752205F4,7,1,8,0.454545,165.261905,0,0,0.136385
3413,777242F7,1,0,1,0,0,0,0,0.003312
3414,753127A1,1,0,1,0,0,0,0,0.003312
3415,76CD2C4C,0,3,3,0.6,0,0,0,0
3416,77CB0C5D,2,0,2,0,0,0,0,0.006624
3417,7A7DC961,1,0,1,0,0,0,0,0.003312
3418,7E520CC0,0,1,1,0.666667,0,0,0,0
3419,77759A0D,1,0,1,0,0,0,0,0.003312
3420,80415FC4,5,4,9,0.380282,115.666667,0,0,0.020973
3421,7B1BE595,5,3,8,1,22.166667,0.000009,0.000009,0.041061
3422,7D6EE1E8,3,3,6,0.8,12,0,0,0.009935
3423,7D54B687,1,0,1,0,0,0,0,0.003312
3424,78B680CB,0,1,1,0.666667,0,0,0,0
3425,8133A16C,1,1,2,1,0,0,0,0.003312
3426,76444A4C,1,0,1,0,0,0,0,0.003312
3427,7C2B7211,0,1,1,1,0,0,0,0
3428,13B9489A,1,0,1,0,0,0,0,0.003312
3429,7C7E8341,18,12,30,0.565217,621.693254,0,0,0.08443
3430,5F37D416,1,4,5,0.7,5.5,0,0,0.003312
3431,7D22112C,1,2,3,1,2,0,0,0.003312
3432,7C7B22DA,0,2,2,1,0,0,0,0
3433,81785703,0,4,4,1,0,0,0,0
3434,7D999C3B,2,0,2,0,0,0,0,0.008553
3435,7A2B3032,1,0,1,0,0,0,0,0.003312
3436,78C215F1,0,1,1,1,0,0,0,0
3437,61A686A7,1,0,1,0,0,0,0,0.003312
3438,7F72AF76,1,1,2,1,1,0,0,0.003312
3439,7F5C5E59,0,2,2,0.4375,0,0,0,0
3440,79A5F6DC,1,0,1,0,0,0,0,0.003312
3441,810C2240,1,0,1,0,0,0,0,0.003312
3442,785B937B,1,0,1,0,0,0,0,0.003312
3443,7F31088B,1,0,1,0,0,0,0,0.003312
3444,7F841247,1,0,1,0,0,0,0,0.003312
3445,75C8BC75,0,4,4,0.52381,0,0,0,0
3446,794F7347,0,2,2,0.390244,0,0,0,0
3447,7C1CDC68,0,2,2,1,0,0,0,0
3448,787EE8FD,1,0,1,0,0,0,0,0.003312
3449,7FBED8F8,1,0,1,0,0,0,0,0.005241
3450,5C35603B,1,0,1,0,0,0,0,0.003312
3451,7C3CFCC9,0,1,1,1,0,0,0,0
3452,7782AD0F,0,1,1,1,0,0,0,0
3453,7C180E95,1,0,1,0,0,0,0,0.003312
3454,5F948692,3,0,3,0,0,0,0,0.009935
3455,5FAA3B5A,1,0,1,0,0,0,0,0.00717
3456,7F17DC39,1,2,3,0.388889,7,0,0,0.003312
3457,806F24FB,1,1,2,1,1,0,0,0.003312
3458,7991F5CE,0,2,2,1,0,0,0.000001,0
3459,7EF505C9,0,1,1,1,0,0,0,0
3460,806A7A0D,1,0,1,0,0,0,0,0.003312
3461,801757A1,1,1,2,0.4,6,0,0,0.003312
3462,7CF9DAA5,0,1,1,1,0,0,0,0
3463,765ABDB3,1,0,1,0,0,0,0,0.003312
3464,5A855C3A,0,1,1,1,0,0,0,0
3465,7D2426B4,0,1,1,1,0,0,0,0
3466,7DDEAB36,0,5,5,0.337662,0,0,0,0
3467,7EB8D216,0,1,1,1,0,0,0,0
3468,781B4E30,2,0,2,0,0,0,0,0.018109
3469,8149A342,2,0,2,0,0,0,0,0.058887
3470,7A62DB8A,0,1,1,1,0,0,0,0
3471,7DAB48D6,0,1,1,1,0,0,0,0
3472,7BFBBEF9,2,2,4,0.571429,9,0,0,0.006624
3473,80F23112,0,1,1,1,0,0,0,0
3474,75A6770D,1,2,3,1,1,0,0,0.003312
3475,7D3D4817,0,2,2,0.75,0,0,0,0
3476,80B8D28B,0,2,2,0.296875,0,0,0,0
3477,7D1A74A5,0,5,5,0.431818,0,0,0,0
3478,78AE4E66,1,0,1,0,0,0,0,0.016817
3479,78D4BFFA,1,2,3,0.6,5,0.000279,0.00003,0.003312
3480,7A5BDE6D,1,2,3,1,4,0,0,0.011585
3481,78B41ABC,0,1,1,0.6,0,0,0,0
3482,7572595F,1,0,1,0,0,0,0,0.003312
3483,7606326F,0,1,1,1,0,0,0,0
3484,7E9541AD,1,0,1,0,0,0,0,0.003312
3485,7D997094,0,1,1,1,0,0,0,0
3486,78D1A3AF,0,1,1,1,0,0,0,0
3487,7C98B81C,0,1,1,0.287671,0,0,0,0
3488,7DE08DC6,1,0,1,0,0,0,0,0.005241
3489,7DDBCC52,1,2,3,1,2,0,0,0.003312
3490,79CF52DC,0,1,1,1,0,0,0,0
3491,7917278F,0,6,6,0.529412,0,0,0.000383,0
3492,800D00FB,0,5,5,0.578947,0,0,0,0
3493,80DF603A,0,1,1,1,0,0,0,0
3494,786D282F,0,1,1,1,0,0,0,0
3495,78807AFD,1,1,2,1,1,0,0,0.003312
3496,78FC3D2B,0,1,1,1,0,0,0,0
3497,76A165FA,1,0,1,0,0,0,0,0.005241
3498,7F9E93E7,1,0,1,0,0,0,0,0.003312
3499,7F2DF581,0,6,6,0.361111,0,0,0,0
3500,80263B29,0,3,3,1,0,0,0,0
3501,779029D9,1,1,2,1,1,0,0,0.003312
3502,7895181B,1,0,1,0,0,0,0,0.003312
3503,7D8AD003,0,2,2,1,0,0,0,0
3504,7A0E4A1F,0,2,2,0.464286,0,0,0,0
3505,7E623D54,0,1,1,1,0,0,0,0
3506,7858A150,1,0,1,0,0,0,0,0.003312
3507,7833F431,3,0,3,0,0,0,0,0.016279
3508,7E00AF9D,1,3,4,0.8,4,0,0,0.003312
3509,810E4CA7,0,4,4,0.625,0,0,0.117561,0
3510,6DB3C61C,1,0,1,0,0,0,0,0.003312
3511,7B0E47A7,0,1,1,1,0,0,0,0
3512,78EB4160,1,0,1,0,0,0,0,0.003312
3513,7EB5803B,7,3,10,0.714286,29.833333,0,0,0.023182
3514,7B71CB20,1,1,2,1,1,0,0,0.003312
3515,78E763A0,0,1,1,0.666667,0,0,0,0
3516,7AD4A47B,6,0,6,0,0,0,0,0.039403
3517,70B8DA42,1,1,2,1,1,0,0,0.003312
3518,59F0B06B,1,0,1,0,0,0,0,0.005241
3519,8154A367,0,1,1,1,0,0,0,0
3520,8056E7D5,2,5,7,0.777778,3.2,0.025792,0.175268,0.008553
3521,7BBBDA2D,1,0,1,0,0,0,0,0.003312
3522,794F0105,4,0,4,0,0,0,0,0.026753
3523,5F53F602,0,1,1,1,0,0,0,0
3524,7C779D8B,0,6,6,0.608696,0,0,0.114882,0
3525,7D458A3F,1,0,1,0,0,0,0,0.003312
3526,81549B0C,8,0,8,0,0,0,0,0.031464
3527,7CE3B1C2,1,1,2,1,0,0,0,0.003312
3528,794203E1,1,0,1,0,0,0,0,0.003312
3529,7B8695AD,1,0,1,0,0,0,0,0.003312
3530,75630475,0,1,1,0.366972,0,0,0,0
3531,814E931D,2,0,2,0,0,0,0,0.006624
3532,7EAF9D52,1,5,6,0.434783,8,0,0,0.003312
3533,7BD94639,0,1,1,1,0,0,0,0
3534,7F9AC9EC,1,4,5,0.514286,18,0,0,0.003312
3535,7F66A487,0,1,1,0.6,0,0,0,0
3536,5A63B9F8,12,0,12,0,0,0.206127,0,0.129937
3537,759D3A2D,1,0,1,0,0,0,0,0.005241
3538,802A50F2,0,1,1,1,0,0,0,0
3539,04B4F1C6,1,0,1,0,0,0,0,0.003312
3540,80CF338B,0,2,2,1,0,0,0,0
3541,7A010DF2,1,0,1,0,0,0,0,0.003312
3542,7A5F7A38,2,0,2,0,0,0,0,0.017936
3543,7937F799,0,1,1,1,0,0,0,0
3544,810AB272,0,1,1,1,0,0,0,0
3545,80CE7448,2,0,2,0,0,0,0,0.011248
3546,7EA3AA9F,0,1,1,0.666667,0,0,0,0
3547,6188C129,1,0,1,0,0,0,0,0.003312
3548,7D9EA82C,0,1,1,1,0,0,0,0
3549,7B385B63,0,3,3,0.481481,0,0,0,0
3550,7E427BEA,1,0,1,0,0,0,0,0.003312
3551,7F26396B,0,1,1,1,0,0,0,0
3552,76714782,3,2,5,0.37037,21,0,0,0.009935
3553,76476143,0,3,3,0.714286,0,0,0,0
3554,767E25D3,1,0,1,0,0,0,0,0.003312
3555,80BD414C,2,0,2,0,0,0,0,0.015452
3556,5BC8BCEC,1,0,1,0,0,0,0,0.005241
3557,7D3444B9,4,1,5,1,4,0,0,0.015176
3558,7EFAFB7B,1,0,1,0,0,0,0,0.003312
3559,80E9CED4,1,1,2,0.410256,0,0,0,0.008281
3560,5898640B,1,4,5,0.75,6,0,0,0.003312
3561,7AA9A74A,1,0,1,0,0,0,0,0.003312
3562,5D5E5C93,0,3,3,0.328358,0,0,0,0
3563,7FBA7515,0,2,2,0.6,0,0,0,0
3564,7DB8DAA8,0,3,3,0.8,0,0,0,0
3565,814FCEF0,0,1,1,0.368421,0,0,0,0
3566,7D249FEF,0,1,1,0.666667,0,0,0,0
3567,7DC747D9,2,0,2,0,0,0,0,0.006624
3568,80B4C7AA,2,7,9,0.62963,18,0.030291,0.11195,0.008553
3569,77324B35,0,3,3,1,0,0,0,0
3570,5E44965F,0,1,1,0.375,0,0,0,0
3571,7BF79ED5,0,1,1,1,0,0,0,0
3572,79C80766,1,0,1,0,0,0,0,0.003312
3573,75935C2B,0,1,1,1,0,0,0,0
3574,751A61B9,3,5,8,0.642857,21,0,0,0.009935
3575,7E16E1C1,0,3,3,0.529412,0,0,0,0
3576,79F99CD6,1,0,1,0,0,0,0,0.003312
3577,77AD3446,0,1,1,1,0,0,0,0
3578,75BE6741,2,0,2,0,0,0,0,0.006624
3579,7EB18A60,0,1,1,1,0,0,0,0
3580,79474497,0,1,1,1,0,0,0,0
3581,7BD05826,0,7,7,0.705882,0,0,0,0
3582,798A3B9D,1,0,1,0,0,0,0,0.003312
3583,779D62A2,2,0,2,0,0,0,0,0.008553
3584,7D4FC08A,0,3,3,1,0,0,0,0
3585,7657590E,1,0,1,0,0,0,0,0.003312
3586,8047BF14,2,3,5,0.363636,27,0,0,0.008553
3587,7CEEA2E1,0,5,5,0.367089,0,0,0,0
3588,6F1FA82D,1,0,1,0,0,0,0,0.003312
3589,777DB6E5,0,1,1,1,0,0,0,0
3590,805C7933,1,1,2,1,0,0,0,0.003312
3591,76DB24E7,1,2,3,0.404762,17,0,0,0.003312
3592,065A85E2,2,1,3,1,2,0,0,0.010482
3593,08F1233A,1,0,1,0,0,0,0,0.034663
3594,7E1357FC,32,1,33,0.666667,114.5,0,0,0.201022
3595,7920FB8A,10,0,10,0,0,0,0,0.072341
3596,7E900428,3,0,3,0,0,0,0,0.015723
3597,7DAC184F,0,3,3,0.8,0,0,0,0
3598,7F513352,1,2,3,1,0,0,0,0.003312
3599,7790F682,1,0,1,0,0,0,0,0.003312
3600,80CD0B01,0,1,1,0.666667,0,0,0,0
3601,5CFF37F8,1,0,1,0,0,0,0,0.003312
3602,7FBC1A95,3,0,3,0,0,0,0,0.014349
3603,816C5AD5,0,3,3,0.439024,0,0,0,0
3604,7FD90050,0,1,1,1,0,0,0,0
3605,7EC17058,1,0,1,0,0,0,0,0.003312
3606,5C3ED537,1,0,1,0,0,0,0,0.011532
3607,7B75D3D8,8,1,9,0.545455,8.333333,0.128527,0.053363,0.058796
3608,803A5555,1,0,1,0,0,0,0,0.012853
3609,77309D4F,1,0,1,0,0,0,0,0.003312
3610,7BE9B5B0,0,1,1,1,0,0,0,0
3611,75F58B81,4,0,4,0,0,0,0,0.038013
3612,7AA96198,1,0,1,0,0,0,0,0.003312
3613,802DBB00,0,2,2,1,0,0,0,0
3614,75CA5A03,1,0,1,0,0,0,0,0.003312
3615,80E6F26C,0,1,1,0.666667,0,0,0,0
3616,7A787806,0,7,7,0.571429,0,0,0,0
3617,78F7829E,0,1,1,0.375,0,0,0,0
3618,7A89A7B9,5,0,5,0,0,0,0,0.025703
3619,7B578B6D,0,1,1,1,0,0,0,0
3620,78A77F76,6,0,6,0,0,0,0,0.074978
3621,7B65880A,1,0,1,0,0,0,0,0.003312
3622,7675F405,2,0,2,0,0,0,0,0.008553
3623,7D1A85E5,2,8,10,1,18.5,0,0,0.008553
3624,8016DDC7,0,1,1,0.538462,0,0,0,0
3625,5B59CBFD,1,1,2,1,0.5,0,0,0.003312
3626,7CF2CAAB,0,4,4,1,0,0,0.067945,0
3627,807E373A,3,0,3,0,0,0,0,0.020302
3628,75C537AA,1,0,1,0,0,0,0,0.003312
3629,7D0C9B16,2,1,3,1,1,0,0,0.006624
3630,7F4D0C86,2,2,4,1,3,0,0,0.006624
3631,75128D9E,0,2,2,0.555556,0,0,0,0
3632,803EE591,0,1,1,1,0,0,0,0
3633,7FA0988B,1,0,1,0,0,0,0,0.003312
3634,7A2C1ED5,2,2,4,0.441176,1,0.003574,0.033721,0.006624
3635,043D6B38,2,0,2,0,0,0,0,0.006624
3636,75106740,1,0,1,0,0,0,0,0.003312
3637,7B28C6E1,1,0,1,0,0,0,0,0.003312
3638,79B6D95F,0,1,1,1,0,0,0,0
3639,137AEB7B,0,1,1,1,0,0,0.032988,0
3640,7621879A,0,5,5,0.463415,0,0,0,0
3641,780A5023,3,0,3,0,0,0,0,0.009935
3642,0B0E8C57,4,2,6,0.5,43.5,0,0,0.082075
3643,7ED30F7B,1,1,2,1,1,0,0,0.003312
3644,7E9E1018,0,1,1,1,0,0,0,0
3645,78A17386,0,1,1,1,0,0,0,0
3646,7BDF2656,2,0,2,0,0,0,0,0.006624
3647,7EAEE933,1,0,1,0,0,0,0,0.003312
3648,7B8CF8B7,1,0,1,0,0,0,0,0.005241
3649,8087806B,2,1,3,1,2,0,0,0.006624
3650,7D31EF64,2,0,2,0,0,0,0,0.006624
3651,7F399A29,1,4,5,0.6,9,0,0,0.003312
3652,772BF660,0,4,4,0.833333,0,0,0,0
3653,78D67CD8,0,3,3,0.343915,0,0,0,0
3654,7DB534DA,3,5,8,0.56,14.2,0,0,0.045877
3655,76FECEA0,2,0,2,0,0,0,0,0.025946
3656,7C95A832,1,0,1,0,0,0,0,0.020413
3657,03543955,0,1,1,1,0,0,0,0
3658,5DACF433,1,0,1,0,0,0,0,0.005241
3659,7A2CC295,1,0,1,0,0,0,0,0.003312
3660,7558ED05,0,4,4,0.382716,0,0,0,0
3661,5D529EB0,0,1,1,1,0,0,0,0
3662,7EA2D3E6,1,0,1,0,0,0,0,0.005241
3663,813283EF,1,3,4,0.481481,0.5,0.000039,0.000009,0.003312
3664,7BF7415F,0,5,5,0.6,0,0,0.098842,0
3665,76109F92,0,1,1,1,0,0,0,0
3666,78CB7ADE,2,7,9,0.625,25,0,0,0.017592
3667,76EE52E4,1,0,1,0,0,0,0,0.005241
3668,77514152,2,0,2,0,0,0,0,0.008553
3669,7D183C31,0,1,1,1,0,0,0,0
3670,7AF3791D,0,4,4,0.833333,0,0,0,0
3671,7C66B35B,0,1,1,1,0,0,0,0
3672,7E6A25CA,0,2,2,1,0,0,0,0
3673,812F9278,1,0,1,0,0,0,0,0.003312
3674,7E3BD3A9,1,1,2,0.666667,0,0,0,0.003312
3675,76418B47,1,0,1,0,0,0,0,0.003312
3676,7F9A303A,1,2,3,1,2,0,0,0.003312
3677,7F6326CF,1,0,1,0,0,0,0,0.003312
3678,79879B59,2,0,2,0,0,0,0,0.006624
3679,7FE6F0AB,2,0,2,0,0,0,0,0.006624
3680,810347E0,0,2,2,0.335938,0,0,0,0
3681,79C5BDAF,1,0,1,0,0,0,0,0.003312
3682,8019DEC0,0,1,1,1,0,0,0,0
3683,81250263,1,0,1,0,0,0,0,0.003312
3684,79010B71,1,0,1,0,0,0,0,0.007726
3685,7ED13879,1,1,2,1,1,0,0,0.003312
3686,7A6E5EF7,1,0,1,0,0,0,0,0.003312
3687,7D8C56A2,0,1,1,1,0,0,0,0
3688,8094EB93,5,0,5,0,0,0,0,0.067604
3689,7702620E,1,0,1,0,0,0,0,0.003312
3690,79FCC4A3,0,1,1,1,0,0,0,0
3691,77AACB1E,0,1,1,1,0,0,0,0
3692,7FBD9ABF,0,1,1,1,0,0,0,0
3693,02F0F321,1,0,1,0,0,0,0,0.003312
3694,809F647F,2,2,4,0.555556,7,0,0,0.006624
3695,7ACDB178,1,0,1,0,0,0,0,0.005241
3696,7997664F,1,0,1,0,0,0,0,0.003312
3697,7E532F67,1,0,1,0,0,0,0,0.003312
3698,76346FF5,1,0,1,0,0,0,0,0.003312
3699,6DD28019,1,0,1,0,0,0,0,0.010871
3700,80D0094F,2,1,3,1,5,0,0,0.011038
3701,7D52FC34,2,0,2,0,0,0,0,0.008553
3702,757996B9,1,0,1,0,0,0,0,0.005796
3703,754E08D7,1,0,1,0,0,0,0,0.003312
3704,7A64C19E,0,2,2,0.666667,0,0,0,0
3705,7C3ED42F,1,0,1,0,0,0,0,0.003312
3706,81296E0C,0,1,1,1,0,0,0,0
3707,5E3FBB4D,15,6,21,0.5,302.833333,0,0,0.113605
3708,7E980DFB,1,0,1,0,0,0,0,0.0091
3709,789EA22E,1,0,1,0,0,0,0,0.003312
3710,7855097D,0,1,1,1,0,0,0,0
3711,7DF06606,0,2,2,0.292135,0,0,0,0
3712,78A8378B,1,0,1,0,0,0,0,0.003312
3713,7D82FD27,0,2,2,1,0,0,0,0
3714,7DA69577,1,4,5,0.513514,82,0,0,0.011585
3715,80737492,0,1,1,1,0,0,0,0
3716,61E72BFB,5,0,5,0,0,0,0,0.025387
3717,76808D5D,1,0,1,0,0,0,0,0.003312
3718,7C66E1B3,4,0,4,0,0,0,0,0.015176
3719,7FB5B957,0,1,1,0.666667,0,0,0,0
3720,753B1758,0,1,1,0.6,0,0,0,0
3721,7E8770D0,1,0,1,0,0,0,0,0.005241
3722,7B7D11D2,4,0,4,0,0,0.000006,0,0.026436
3723,7F7C31AC,2,2,4,0.4,9.095238,0,0,0.006624
3724,81CD45E0,0,1,1,1,0,0,0,0
3725,7DC072E6,0,3,3,0.714286,0,0,0,0
3726,8103670C,0,1,1,1,0,0,0,0
3727,7C7111AF,4,2,6,1,3,0,0,0.017106
3728,6E066EFF,1,1,2,1,6,0,0,0.010211
3729,7CBBF504,2,0,2,0,0,0,0,0.006624
3730,7743E229,1,0,1,0,0,0,0,0.003312
3731,7A06A05B,3,0,3,0,0,0,0,0.011865
3732,79645057,1,0,1,0,0,0,0,0.003312
3733,77D6EDBB,1,0,1,0,0,0,0,0.003312
3734,7A777666,1,0,1,0,0,0,0,0.003312
3735,7FC6192A,1,0,1,0,0,0,0,0.010421
3736,7E67BBA5,0,2,2,0.75,0,0,0,0
3737,8068A838,0,3,3,1,0,0,0,0
3738,7C2B2113,0,1,1,0.666667,0,0,0,0
3739,75B6DFAE,0,1,1,1,0,0,0,0
3740,7DC5F118,1,1,2,1,0,0,0,0.003312
3741,76C891D1,2,0,2,0,0,0,0,0.012412
3742,7F583D17,0,3,3,0.52381,0,0,0,0
3743,805F1F61,1,0,1,0,0,0,0,0.003312
3744,7765C5DC,1,0,1,0,0,0,0,0.003312
3745,7CF1F9F2,1,0,1,0,0,0,0,0.003312
3746,7A20C8D0,0,1,1,1,0,0,0,0
3747,798CB2B9,1,0,1,0,0,0,0,0.003312
3748,7D6EC2FE,1,3,4,0.409091,1.166667,0,0,0.016817
3749,7EBCD91D,0,1,1,1,0,0,0,0
3750,7553080D,0,2,2,1,0,0,0,0
3751,803D3C9E,2,0,2,0,0,0,0,0.008553
3752,7D4ED00F,0,1,1,1,0,0,0,0
3753,7C46C596,0,2,2,1,0,0,0,0
3754,5ACBCED3,1,2,3,0.454545,0,0,0,0.003312
3755,7A70FAB3,1,0,1,0,0,0,0,0.005241
3756,808821B1,0,2,2,1,0,0,0,0
3757,75D232AC,1,0,1,0,0,0,0,0.003312
3758,76593536,0,2,2,1,0,0,0,0
3759,8148F73C,3,1,4,1,3,0,0,0.009935
3760,5E6B2A92,0,1,1,1,0,0,0,0
3761,77C2D596,0,1,1,1,0,0,0,0
3762,7A2E6D87,0,4,4,0.439024,0,0,0,0
3763,77BB6AC7,17,0,17,0,0,0,0,0.327071
3764,7AEAE117,0,1,1,1,0,0,0,0
3765,78B80947,0,1,1,0.666667,0,0,0,0
3766,81234621,1,0,1,0,0,0,0,0.003312
3767,791FA91D,0,4,4,0.555556,0,0,0,0
3768,7FC4F120,2,0,2,0,0,0,0,0.006624
3769,7A964561,0,2,2,1,0,0,0,0
3770,81BBC62E,0,2,2,1,0,0,0,0
3771,8125B5D6,2,1,3,1,2,0,0,0.006624
3772,7BB41091,1,0,1,0,0,0,0,0.003312
3773,7E2C52DB,1,0,1,0,0,0,0,0.003312
3774,77E40B26,3,1,4,1,3,0,0,0.011865
3775,76908A52,0,2,2,0.5,0,0,0.000001,0
3776,7CC6B72A,0,1,1,1,0,0,0,0
3777,5E4C2B93,0,1,1,0.6,0,0,0,0
3778,7DC6514C,0,1,1,1,0,0,0,0
3779,81EBC3E5,1,0,1,0,0,0,0,0.003312
3780,7997DECE,0,1,1,1,0,0,0,0
3781,7E65E026,1,0,1,0,0,0,0,0.003312
3782,784A25A2,1,0,1,0,0,0,0,0.003312
3783,816A5873,2,0,2,0,0,0,0,0.006624
3784,7D013575,0,1,1,0.382353,0,0,0,0
3785,5998D8DD,1,0,1,0,0,0,0,0.010871
3786,7717AC53,4,2,6,1,6,0,0,0.013247
3787,7F22D436,4,0,4,0,0,0,0,0.022894
3788,81460CA9,0,2,2,1,0,0,0,0
3789,7F2504AA,0,1,1,0.384615,0,0,0,0
3790,7DFE079F,1,1,2,1,1,0,0,0.003312
3791,7B45EB11,3,1,4,1,4,0,0,0.011865
3792,7F29567B,3,0,3,0,0,0,0,0.013794
3793,5AA02E20,1,0,1,0,0,0,0,0.003312
3794,7968A65A,2,0,2,0,0,0,0,0.012412
3795,7B8823D5,1,0,1,0,0,0,0,0.005241
3796,05C13191,1,0,1,0,0,0,0,0.005241
3797,7CA7CC51,1,1,2,0.666667,2,0,0,0.003312
3798,073B3AE2,1,0,1,0,0,0,0,0.014888
3799,77F87CCC,1,0,1,0,0,0,0,0.003312
3800,78BBC2BB,3,0,3,0,0,0,0,0.011865
3801,79921B25,0,2,2,1,0,0,0,0
3802,756E1471,0,1,1,1,0,0,0,0
3803,786B1BA1,2,0,2,0,0,0,0,0.008553
3804,7F832BB6,0,1,1,0.375,0,0,0,0
3805,7CF1818D,0,2,2,1,0,0,0,0
3806,76AFDA64,1,0,1,0,0,0,0,0.003312
3807,77CDF820,0,2,2,1,0,0,0.046466,0
3808,7D80FB7E,2,2,4,0.5,4.5,0,0,0.010482
3809,7428C84B,2,0,2,0,0,0,0,0.017936
3810,75B6CC88,0,2,2,0.75,0,0,0,0
3811,805443E0,1,0,1,0,0,0,0,0.00717
3812,79D2F02E,0,1,1,1,0,0,0,0
3813,7F372359,5,0,5,0,0,0,0,0.051325
3814,789CD384,0,2,2,0.75,0,0,0,0
3815,7948E6C3,5,0,5,0,0,0,0,0.027
3816,7F1906B5,0,2,2,0.666667,0,0,0,0
3817,7F6B8CC3,0,1,1,1,0,0,0,0
3818,7F350AA2,0,1,1,1,0,0,0,0
3819,769504E2,4,0,4,0,0,0,0,0.013247
3820,7528F949,1,0,1,0,0,0,0,0.016329
3821,80E40DE2,11,0,11,0,0,0,0,0.100419
3822,78996A1D,1,0,1,0,0,0,0,0.003312
3823,797BC491,1,0,1,0,0,0,0,0.005241
3824,77BC3C76,1,0,1,0,0,0,0,0.003312
3825,7B86C5EA,1,0,1,0,0,0,0,0.005241
3826,7CB25658,0,1,1,1,0,0,0,0
3827,7E94CE83,1,0,1,0,0,0,0,0.003312
3828,7F6BDB76,0,6,6,1,0,0,0,0
3829,7D485214,1,9,10,0.553191,20.5,0.008858,0.158421,0.003312
3830,7FD981CF,0,2,2,1,0,0,0,0
3831,7F76B788,0,5,5,0.4,0,0,0,0
3832,811D48B0,1,0,1,0,0,0,0,0.00717
3833,757A362A,0,1,1,1,0,0,0,0
3834,7B73503A,1,0,1,0,0,0,0,0.003312
3835,791F988E,1,0,1,0,0,0,0,0.003312
3836,7A6DD27E,1,0,1,0,0,0,0,0.003312
3837,7F3DD54B,0,3,3,0.393939,0,0,0,0
3838,77052460,3,0,3,0,0,0,0,0.011865
3839,7A46CD60,1,0,1,0,0,0,0,0.006534
3840,812687CE,3,2,5,0.75,25,0,0,0.022727
3841,7C806007,2,3,5,0.666667,6.333333,0.026538,0.132338,0.0219
3842,7AE490B6,3,0,3,0,0,0.000001,0,0.051488
3843,8052DFA6,0,1,1,0.666667,0,0,0,0
3844,7B9CDFB0,1,1,2,1,1,0,0,0.003312
3845,7A788944,2,1,3,1,2,0,0,0.008553
3846,81CFAC73,4,0,4,0,0,0,0,0.02456
3847,0A371E5A,1,0,1,0,0,0,0,0.003312
3848,630ED363,2,0,2,0,0,0,0,0.006624
3849,7D0DB170,0,6,6,0.420561,0,0,0,0
3850,7A7A52A5,2,0,2,0,0,0,0,0.014896
3851,7EDEFA96,1,0,1,0,0,0,0,0.003312
3852,6D83A626,1,0,1,0,0,0,0,0.003312
3853,7F3F0679,0,1,1,1,0,0,0,0
3854,7D257B3E,0,1,1,1,0,0,0,0
3855,75CE618C,0,1,1,1,0,0,0,0
3856,12948C4F,1,0,1,0,0,0,0,0.005796
3857,628C55FC,2,0,2,0,0,0,0,0.018018
3858,8174376A,0,4,4,0.320513,0,0,0,0
3859,81B691E9,1,0,1,0,0,0,0,0.003312
3860,75A9F730,0,1,1,0.666667,0,0,0,0
3861,7CC8DBAC,3,0,3,0,0,0,0,0.013794
3862,78BF0A21,1,0,1,0,0,0,0,0.003312
3863,77484842,0,3,3,0.538462,0,0,0,0
3864,809A1F77,0,2,2,1,0,0,0,0
3865,7F48F809,1,0,1,0,0,0,0,0.00717
3866,766F74AA,5,0,5,0,0,0,0,0.018488
3867,787D87FB,0,3,3,0.8,0,0,0,0
3868,7BDF0A10,1,3,4,1,2,0,0,0.003312
3869,7E357EB5,0,2,2,1,0,0,0,0
3870,7CA219F7,1,6,7,0.590909,39,0,0,0.005796
3871,5A61B482,1,0,1,0,0,0,0,0.003312
3872,6FABF918,1,2,3,0.3,21,0,0,0.003312
3873,7D8C026D,2,4,6,1,6.5,0,0,0.012412
3874,7A9FCA69,1,0,1,0,0,0,0,0.005796
3875,7DF39BFA,13,0,13,0,0,0,0,0.093855
3876,7842CE13,1,0,1,0,0,0,0,0.005241
3877,5F875866,11,2,13,0.5,53.895238,0,0,0.068702
3878,81AB67E3,2,2,4,0.625,9,0,0,0.006624
3879,78B36246,1,0,1,0,0,0,0,0.003312
3880,803AA222,0,3,3,1,0,0,0,0
3881,7922C639,0,1,1,1,0,0,0,0
3882,7C60ECBB,1,0,1,0,0,0,0,0.010871
3883,762700D7,2,0,2,0,0,0,0,0.008553
3884,760E69EA,1,0,1,0,0,0,0,0.003312
3885,80CB5DE6,7,36,43,0.695122,395.916667,0,0,0.023182
3886,7A78E9E7,1,0,1,0,0,0,0,0.003312
3887,7B7064F6,0,1,1,1,0,0,0,0
3888,79BCBA15,0,6,6,0.333333,0,0,0,0
3889,7C1C536A,1,1,2,1,1,0,0,0.003312
3890,7BD80624,1,0,1,0,0,0,0,0.003312
3891,7DB2E60A,0,1,1,1,0,0,0,0
3892,7B09541A,2,0,2,0,0,0,0,0.029168
3893,5AA8D250,1,2,3,1,1,0,0,0.003312
3894,7B7431C2,1,0,1,0,0,0,0,0.003312
3895,81489E04,1,0,1,0,0,0,0,0.003312
3896,781FB29A,1,0,1,0,0,0,0,0.003312
3897,77923EB2,1,2,3,0.583333,7,0.000003,0.074289,0.003312
3898,7ECC9A93,0,2,2,1,0,0,0,0
3899,75C723F9,0,2,2,0.555556,0,0,0,0
3900,80166EE2,0,1,1,1,0,0,0,0
3901,7753D8D6,1,2,3,1,1,0,0,0.003312
3902,80ABF565,0,1,1,1,0,0,0,0
3903,81336D5D,3,6,9,0.727273,34,0,0,0.01242
3904,584D42BD,0,3,3,1,0,0,0,0
3905,810E7553,1,1,2,0.357143,10,0,0,0.003312
3906,8109BFF2,0,1,1,1,0,0,0,0
3907,789E4D96,0,1,1,1,0,0,0,0
3908,80144CFA,3,6,9,0.631579,22,0.000011,0.000021,0.022622
3909,7C241AA5,10,2,12,0.571429,79,0,0,0.146848
3910,7B560F78,1,0,1,0,0,0,0,0.00717
3911,77A0F4EE,0,1,1,1,0,0,0,0
3912,7A681FF0,1,0,1,0,0,0,0,0.003312
3913,75E5E515,1,2,3,0.666667,2.5,0,0,0.003312
3914,75C87044,1,1,2,0.5,5,0,0,0.003312
3915,7976B0FE,2,1,3,1,2,0,0,0.006624
3916,80A46FDF,0,1,1,0.304348,0,0,0,0
3917,80865320,1,0,1,0,0,0,0,0.003312
3918,7D51A623,0,1,1,1,0,0,0,0
3919,7788FEE2,5,1,6,0.5,1.283333,0,0,0.042292
3920,7CE12602,1,0,1,0,0,0,0,0.005796
3921,79BAA0EF,0,3,3,1,0,0,0,0
3922,76DD4BE2,0,2,2,1,0,0,0,0
3923,7E88F062,1,1,2,1,1,0,0,0.003312
3924,8077E0C4,0,2,2,0.75,0,0,0,0
3925,5ECEA42F,1,0,1,0,0,0,0,0.003312
3926,785C8515,1,1,2,0.5,0.569444,0,0,0.005241
3927,7947A76B,1,0,1,0,0,0,0,0.003312
3928,7FFE5A6D,1,2,3,1,2,0,0,0.003312
3929,817187DA,0,1,1,1,0,0,0,0
3930,6D7C592C,0,1,1,1,0,0,0,0
3931,7A77B816,3,0,3,0,0,0,0,0.026878
3932,79B31530,1,1,2,0.545455,6,0,0,0.003312
3933,7ED170D3,0,1,1,1,0,0,0,0
3934,78EA57FF,1,0,1,0,0,0,0,0.003312
3935,775FADB2,0,3,3,0.714286,0,0,0,0
3936,7BB84E64,1,0,1,0,0,0,0,0.003312
3937,5B8A9D08,2,1,3,1,4,0,0,0.012412
3938,80A79A5D,0,2,2,0.5,0,0,0,0
3939,79D5A11E,1,0,1,0,0,0,0,0.003312
3940,8029C849,2,1,3,1,0.25,0,0,0.006624
3941,78A77FEE,1,0,1,0,0,0,0,0.003312
3942,76A844AB,1,0,1,0,0,0,0,0.003312
3943,81403FA0,0,2,2,1,0,0,0,0
3944,7C168439,0,1,1,1,0,0,0,0
3945,791006D5,0,1,1,0.571429,0,0,0,0
3946,7590F589,0,1,1,1,0,0,0,0
3947,61B3E84F,0,1,1,0.666667,0,0,0,0
3948,75497517,12,0,12,0,0,0.215321,0,0.098364
3949,7F27AC43,0,1,1,1,0,0,0,0
3950,75E26B7E,0,1,1,1,0,0,0,0
3951,7A7CDF5E,1,0,1,0,0,0,0,0.003312
3952,75E4640B,2,4,6,1,27,0,0,0.03223
3953,780D3799,2,3,5,0.8,6,0,0,0.008553
3954,7562D7EF,0,1,1,1,0,0,0,0
3955,76AD7FEA,1,0,1,0,0,0,0,0.003312
3956,7E763FDF,0,4,4,0.75,0,0,0,0
3957,7A521975,2,0,2,0,0,0,0,0.006624
3958,7F8FA987,2,0,2,0,0,0,0,0.009108
3959,77004114,2,0,2,0,0,0,0,0.145447
3960,8159235D,6,0,6,0,0,0.070286,0,0.026214
3961,81706E96,0,2,2,1,0,0,0,0
3962,7B2478ED,1,5,6,0.777778,4,0,0,0.003312
3963,7AC81507,1,1,2,1,3,0,0,0.005796
3964,773D35E7,0,1,1,1,0,0,0,0
3965,7A9ADFB6,1,0,1,0,0,0,0,0.003312
3966,7D09730C,0,3,3,0.714286,0,0,0,0
3967,8028033C,0,7,7,0.463415,0,0,0,0
3968,7D723443,0,1,1,1,0,0,0,0
3969,75CE039F,0,2,2,0.4,0,0,0,0
3970,7C82B3D9,1,0,1,0,0,0,0,0.003312
3971,806CD02A,2,0,2,0,0,0,0,0.006624
3972,7E752645,2,0,2,0,0,0,0,0.008553
3973,76C25EDC,5,3,8,1,15.5,0.000044,0.001548,0.020418
3974,7FE2E7A0,3,2,5,0.533333,33.061905,0,0,0.101799
3975,7E884A28,1,1,2,1,1,0,0,0.003312
3976,75A3FA18,1,0,1,0,0,0,0,0.003312
3977,0039742C,0,1,1,1,0,0,0,0
3978,7A8DF043,0,1,1,0.666667,0,0,0,0
3979,7EB7680A,1,2,3,0.416667,35,0,0,0.003312
3980,78E4951D,0,1,1,1,0,0,0,0
3981,7A3C3B12,1,0,1,0,0,0,0,0.003312
3982,7686665D,0,5,5,0.590909,0,0,0,0
3983,78569FA6,1,0,1,0,0,0,0,0.003312
3984,7EC34DED,1,0,1,0,0,0,0,0.003312
3985,76299500,1,5,6,0.5,4,0.016083,0.075967,0.005241
3986,7D9E0E28,1,0,1,0,0,0,0,0.003312
3987,7FD42739,1,0,1,0,0,0,0,0.003312
3988,7E5ADC2F,0,1,1,0.666667,0,0,0,0
3989,780DF595,0,2,2,0.625,0,0,0,0
3990,0750E254,0,2,2,1,0,0,0,0
3991,7EDDBBFE,4,2,6,0.75,11,0,0,0.015176
3992,7DD343CD,0,3,3,0.714286,0,0,0,0
3993,78FB4350,2,0,2,0,0,0,0,0.01244
3994,03D99C5D,1,0,1,0,0,0,0,0.003312
3995,7E94C1B1,3,0,3,0,0,0,0,0.020205
3996,7554763D,1,0,1,0,0,0,0,0.003312
3997,7ACAC164,1,0,1,0,0,0,0,0.003312
3998,2CBF9C19,1,0,1,0,0,0,0,0.00717
3999,7CA11345,0,1,1,1,0,0,0,0
4000,7E419037,1,13,14,0.634146,22.5,0,0,0.016817
4001,81E9A372,0,4,4,0.333333,0,0,0,0
4002,7CC8CA1D,1,1,2,1,0,0,0,0.003312
4003,7D24551C,5,0,5,0,0,0,0,0.039943
4004,77D436B8,1,1,2,1,1,0,0,0.003312
4005,80A6D148,0,1,1,1,0,0,0,0
4006,7B65AD4A,1,0,1,0,0,0,0,0.005241
4007,7B8EA8A1,0,1,1,1,0,0,0,0
4008,7B503D63,1,0,1,0,0,0,0,0.003312
4009,7F42A019,2,0,2,0,0,0,0,0.008553
4010,7E91239B,3,2,5,1,6,0,0,0.009935
4011,766E145D,1,0,1,0,0,0,0,0.003312
4012,7D5C5FC0,0,1,1,1,0,0,0,0
4013,793D3161,1,0,1,0,0,0,0,0.005241
4014,7ED59FD1,0,1,1,0.6,0,0,0,0
4015,793FE1C5,1,0,1,0,0,0,0,0.006007
4016,5F8EDF3A,0,1,1,1,0,0,0,0
4017,63F51EB5,1,0,1,0,0,0,0,0.003312
4018,7590A351,0,1,1,1,0,0,0,0
4019,7FEE85AD,1,0,1,0,0,0,0,0.003312
4020,7B51D4C8,2,0,2,0,0,0,0,0.020387
4021,6EC9F261,0,1,1,1,0,0,0,0
4022,753063BA,0,1,1,1,0,0,0,0
4023,79EA8DDF,0,1,1,0.6,0,0,0,0
4024,77D31330,0,1,1,1,0,0,0,0
4025,76487855,0,3,3,0.8,0,0,0,0
4026,79631D0C,1,1,2,1,0,0,0,0.003312
4027,7D7A2CE0,0,6,6,0.625,0,0,0,0
4028,7F1832E9,4,3,7,0.365385,110.833333,0,0,0.024005
4029,5CCA77EC,24,0,24,0,0,0.312423,0,0.424498
4030,816019B0,0,1,1,1,0,0,0,0
4031,766CC1F0,0,1,1,1,0,0,0,0
4032,7CE0973D,0,4,4,1,0,0,0,0
4033,7DCBE0E1,2,0,2,0,0,0,0,0.006624
4034,812C33A9,0,3,3,0.8,0,0,0,0
4035,773CA052,1,0,1,0,0,0,0,0.003312
4036,58BC02BD,1,0,1,0,0,0,0,0.003312
4037,7F3212DF,0,2,2,0.41844,0,0,0,0
4038,79F67B86,1,1,2,1,0,0,0,0.003312
4039,812C454F,1,6,7,1,48.666667,0,0,0.024578
4040,588DED2B,1,2,3,0.4,8,0,0,0.003312
4041,7E33DF85,0,2,2,0.75,0,0,0,0
4042,75569755,0,1,1,0.6,0,0,0,0
4043,7EA8F88E,0,2,2,1,0,0,0,0
4044,7756265E,1,0,1,0,0,0,0,0.003312
4045,7EFEE763,1,3,4,0.8,4,0,0,0.003312
4046,76E9030C,1,0,1,0,0,0,0,0.003312
4047,7A285BD3,0,3,3,1,0,0,0.000001,0
4048,8066FDBA,1,3,4,0.5,2.5,0,0,0.003312
4049,7ABCFDB8,1,0,1,0,0,0,0,0.003312
4050,7900630B,1,1,2,0.666667,0,0,0,0.003312
4051,7D3F6084,2,1,3,1,3,0,0,0.008553
4052,7FB5AACD,0,5,5,0.578947,0,0,0,0
4053,7D7A0115,2,0,2,0,0,0,0,0.006624
4054,7971CF31,8,1,9,1,23,0,0,0.04853
4055,7FBCEE92,0,2,2,1,0,0,0,0
4056,760D2133,0,2,2,0.625,0,0,0.000004,0
4057,7C22B42F,1,0,1,0,0,0,0,0.003312
4058,60192965,1,0,1,0,0,0,0,0.003312
4059,7E290016,2,8,10,0.543478,42.5,0,0,0.008553
4060,7A2A1B7A,1,0,1,0,0,0,0,0.003312
4061,76014EDC,3,0,3,0,0,0,0,0.013794
4062,7C3B768D,1,0,1,0,0,0,0,0.003312
4063,765245A2,1,0,1,0,0,0,0,0.003312
4064,809D9DFC,8,0,8,0,0,0,0,0.04304
4065,7DA7C147,5,0,5,0,0,0,0,0.030064
4066,7D16FC80,0,4,4,0.378788,0,0,0,0
4067,8174C464,0,3,3,0.266667,0,0,0,0
4068,80F275BE,1,1,2,1,0,0,0,0.003312
4069,7E186202,0,1,1,0.375,0,0,0,0
4070,805138E3,3,0,3,0,0,0,0,0.014349
4071,7FAB8BBF,1,0,1,0,0,0,0,0.003312
4072,7A237D7D,1,0,1,0,0,0,0,0.009129
4073,7AA5F1CC,2,0,2,0,0,0,0,0.008553
4074,78F785F2,1,0,1,0,0,0,0,0.003312
4075,7F281017,2,0,2,0,0,0,0,0.006624
4076,7EF9C410,0,1,1,1,0,0,0,0
4077,7DA0B6A1,1,0,1,0,0,0,0,0.003312
4078,7FACDFD4,0,1,1,1,0,0,0,0
4079,7F3AC10E,1,2,3,1,2,0,0,0.003312
4080,7EB63DD8,2,2,4,0.5,10.166667,0,0,0.012412
4081,7E2C52E6,2,0,2,0,0,0,0,0.008553
4082,780F143C,0,7,7,0.888889,0,0,0,0
4083,81185611,0,1,1,1,0,0,0,0
4084,78FC980A,1,0,1,0,0,0,0,0.003312
4085,80CFD611,1,1,2,0.666667,0,0,0,0.003312
4086,7A97ABF9,1,0,1,0,0,0,0,0.003312
4087,7BF8848F,1,0,1,0,0,0,0,0.003312
4088,81134994,1,3,4,0.666667,6,0,0,0.003312
4089,76D6106F,2,0,2,0,0,0,0,0.006624
4090,7E216E64,0,1,1,1,0,0,0,0
4091,7FD0C7BD,2,0,2,0,0,0,0,0.008553
4092,815972D2,0,4,4,0.266187,0,0,0,0
4093,7B90E712,0,1,1,1,0,0,0,0
4094,76FD8292,2,0,2,0,0,0,0,0.018109
4095,7BE3AD14,1,0,1,0,0,0,0,0.006352
4096,75F0FEAD,1,0,1,0,0,0,0,0.003312
4097,7E76F2AE,0,1,1,1,0,0,0,0
4098,7D1F06A9,4,2,6,0.75,6.5,0,0,0.015176
4099,76653C20,1,1,2,1,1,0,0,0.003312
4100,7E326C93,10,0,10,0,0,0,0,0.136907
4101,7DD4159C,0,1,1,0.666667,0,0,0,0
4102,759B1B83,0,4,4,0.666667,0,0,0,0
4103,7F67B4B3,0,2,2,1,0,0,0,0
4104,7E47F2DE,0,1,1,0.666667,0,0,0,0
4105,784E7D12,0,1,1,1,0,0,0,0
4106,5B25D3DE,0,1,1,1,0,0,0,0
4107,7E990D71,1,0,1,0,0,0,0,0.003312
4108,75B550D9,4,0,4,0,0,0,0,0.027547
4109,780132FC,0,1,1,0.5,0,0,0,0
4110,7F226C1B,2,0,2,0,0,0,0,0.010482
4111,79913991,0,2,2,1,0,0,0,0
4112,812BB97F,3,0,3,0,0,0,0,0.009935
4113,77AD465C,6,0,6,0,0,0,0,0.024285
4114,76FAEF05,0,5,5,0.777778,0,0,0,0
4115,80EB752D,0,2,2,1,0,0,0,0
4116,78D679A0,0,1,1,0.666667,0,0,0,0
4117,794A6B03,1,0,1,0,0,0,0,0.003312
4118,7CA4B8AB,0,1,1,1,0,0,0,0
4119,79A92FCA,4,2,6,0.75,8,0,0,0.013247
4120,811EDEE6,0,1,1,1,0,0,0,0
4121,7D2D995C,1,6,7,0.379747,30,0,0,0.003312
4122,8113B856,1,0,1,0,0,0,0,0.010766
4123,7E42FA17,1,0,1,0,0,0,0,0.003312
4124,805E7010,6,2,8,0.388889,63.261905,0,0,0.095423
4125,796B1EC6,1,0,1,0,0,0,0,0.003312
4126,751F971F,1,0,1,0,0,0,0,0.003312
4127,768003F4,1,1,2,1,7,0,0,0.014888
4128,7B3718EF,1,0,1,0,0,0,0,0.003312
4129,799D205C,1,0,1,0,0,0,0,0.003312
4130,7948F6B8,1,0,1,0,0,0,0,0.003312
4131,7EAB8691,3,0,3,0,0,0,0,0.021803
4132,78B4EB42,0,1,1,1,0,0,0,0
4133,7CF5C5E6,0,1,1,1,0,0,0,0
4134,7AE23F93,0,1,1,0.6,0,0,0,0
4135,75A149EC,4,0,4,0,0,0,0,0.013247
4136,801973CE,0,7,7,0.35514,0,0,0,0
4137,772CDAB9,0,4,4,0.555556,0,0,0,0
4138,62377F4D,1,0,1,0,0,0,0,0.003312
4139,7DEFE4FA,0,5,5,0.777778,0,0,0,0
4140,792263C3,1,0,1,0,0,0,0,0.003312
4141,7DF5E102,0,1,1,1,0,0,0,0
4142,77FFF050,1,0,1,0,0,0,0,0.005241
4143,776378DB,1,0,1,0,0,0,0,0.003312
4144,76533D48,0,1,1,1,0,0,0,0
4145,80D2DE9C,1,0,1,0,0,0,0,0.003312
4146,80C9B043,0,1,1,1,0,0,0,0
4147,77178457,1,0,1,0,0,0,0,0.005241
4148,7B58F9CE,0,1,1,1,0,0,0,0
4149,5E1F2E59,0,2,2,0.666667,0,0,0,0
4150,7819C0DD,0,4,4,0.75,0,0,0,0
4151,7AADDE46,0,3,3,0.545455,0,0,0,0
4152,7D599E04,2,0,2,0,0,0,0,0.035397
4153,7E42FDD3,1,1,2,1,1,0,0,0.003312
4154,77C73BDC,2,0,2,0,0,0,0,0.019602
4155,07096706,5,0,5,0,0,0.014762,0,0.036805
4156,7FD07EE1,0,1,1,1,0,0,0,0
4157,7E2BBB12,0,1,1,0.6,0,0,0,0
4158,7F322B8C,1,0,1,0,0,0,0,0.005241
4159,77E458CF,1,0,1,0,0,0,0,0.003312
4160,793C1E9D,0,3,3,0.714286,0,0,0,0
4161,756E5308,1,0,1,0,0,0,0,0.003312
4162,76A2A818,0,1,1,1,0,0,0,0
4163,7FFB1B96,1,0,1,0,0,0,0,0.003312
4164,7F294000,1,1,2,1,0,0,0,0.003312
4165,7ABCC264,1,0,1,0,0,0,0,0.003312
4166,76F24F56,1,0,1,0,0,0,0,0.003312
4167,7B72DA91,1,0,1,0,0,0,0,0.005241
4168,7D5BC162,0,10,10,0.8125,0,0,0.215907,0
4169,80AEFF8A,0,1,1,0.666667,0,0,0,0
4170,7CA09671,2,2,4,1,1,0,0,0.008553
4171,80666850,0,1,1,1,0,0,0,0
4172,80CC24D7,1,0,1,0,0,0,0,0.003312
4173,754391AC,1,1,2,1,0.5,0,0,0.003312
4174,7CBE18D4,1,1,2,1,1,0,0.000029,0.003312
4175,7F69F82D,1,3,4,0.375,9.166667,0,0,0.003312
4176,7AAE6B07,1,0,1,0,0,0,0,0.003312
4177,79AB8A94,1,0,1,0,0,0,0,0.003312
4178,7D2A2C27,0,1,1,0.5,0,0,0,0
4179,7BF597A8,5,0,5,0,0,0,0,0.016559
4180,79EF6211,1,0,1,0,0,0,0,0.003312
4181,7B71537D,0,1,1,1,0,0,0,0
4182,793131CE,1,0,1,0,0,0,0,0.003312
4183,7A5F81E2,0,5,5,0.393162,0,0,0,0
4184,7C9A040F,2,0,2,0,0,0,0,0.006624
4185,79CC9A46,2,0,2,0,0,0,0,0.006624
4186,7E9D1346,0,1,1,0.434783,0,0,0,0
4187,7DB5BE66,0,3,3,0.287671,0,0,0,0
4188,7695D76D,1,0,1,0,0,0,0,0.003312
4189,7D3AE3C9,0,1,1,0.666667,0,0,0,0
4190,7F1C54BD,0,1,1,1,0,0,0,0
4191,7DF96E25,3,2,5,0.75,15,0,0,0.016279
4192,7E9F1275,14,5,19,0.692308,223.25,0,0,0.075176
4193,75089C0D,1,1,2,0.5,5,0,0,0.003312
4194,785CC059,2,3,5,0.6,6.920635,0,0,0.032357
4195,801201DF,2,0,2,0,0,0,0,0.008553
4196,80300F78,1,0,1,0,0,0,0,0.005241
4197,8032F1A8,1,0,1,0,0,0,0,0.003312
4198,7CDD2250,1,1,2,0.666667,20,0,0,0.013753
4199,7EFBF9DE,0,2,2,1,0,0,0,0
4200,7512C0F4,2,0,2,0,0,0,0,0.011038
4201,810B3BB2,1,0,1,0,0,0,0,0.003312
4202,759E9479,1,0,1,0,0,0,0,0.003312
4203,58AC1B30,4,0,4,0,0,0,0,0.015176
4204,79C37979,41,5,46,1,145.05,0.525634,0.144051,0.304021
4205,7E5ECBC3,1,0,1,0,0,0,0,0.011982
4206,7550BBDB,0,1,1,1,0,0,0,0
4207,7A0073CC,2,0,2,0,0,0.000038,0,0.012412
4208,7674657A,1,0,1,0,0,0,0,0.003312
4209,76B04317,1,0,1,0,0,0,0,0.003312
4210,77209DB8,0,1,1,1,0,0,0,0
4211,814F7719,1,0,1,0,0,0,0,0.003312
4212,7F16326C,1,1,2,1,1,0,0,0.003312
4213,7F37294C,3,0,3,0,0,0,0,0.013794
4214,753939FE,1,0,1,0,0,0,0,0.003312
4215,79D75A23,0,1,1,1,0,0,0,0
4216,7A450E34,2,1,3,1,2,0,0,0.006624
4217,7A76BFAD,1,0,1,0,0,0,0,0.005241
4218,77F03FAF,1,1,2,1,1,0,0,0.003312
4219,7ADCE983,0,2,2,0.75,0,0,0,0
4220,070B258E,1,0,1,0,0,0,0,0.003312
4221,79B3E8F0,2,0,2,0,0,0,0,0.008553
4222,75B1BCB9,1,0,1,0,0,0,0,0.003312
4223,772926FA,0,1,1,1,0,0,0,0
4224,768AB13C,1,0,1,0,0,0,0,0.003312
4225,779B1B4B,1,0,1,0,0,0,0,0.003312
4226,7237CFF4,1,0,1,0,0,0,0,0.003312
4227,7855880A,1,0,1,0,0,0,0,0.003312
4228,7FD13943,0,4,4,1,0,0,0,0
4229,7A410297,1,0,1,0,0,0,0,0.003312
4230,80D6E5C6,0,1,1,1,0,0,0,0
4231,8082BEB1,1,0,1,0,0,0,0,0.005241
4232,7C12A9C4,16,0,16,0,0,0,0,0.105087
4233,7D877CF6,0,1,1,1,0,0,0,0
4234,7DF125BC,1,0,1,0,0,0,0,0.003312
4235,7F2C8F4B,0,2,2,0.75,0,0,0,0
4236,77FFA903,0,1,1,1,0,0,0,0
4237,7BDBEBD8,2,5,7,0.35,31,0,0,0.008553
4238,79314D24,1,0,1,0,0,0,0,0.003312
4239,7FAB9B6D,0,1,1,1,0,0,0,0
4240,75955AD9,1,0,1,0,0,0,0,0.003312
4241,7554F01A,0,1,1,1,0,0,0,0
4242,7FCA804D,1,0,1,0,0,0,0,0.003312
4243,7F5289A1,0,2,2,0.363636,0,0,0,0
4244,7AF62A5A,1,0,1,0,0,0,0,0.003312
4245,7CB4DCB9,0,3,3,1,0,0,0,0
4246,780762FA,0,1,1,0.5,0,0,0,0
4247,7ADBF932,1,1,2,1,1,0,0,0.003312
4248,7E70D7B5,10,5,15,0.363636,133.75,0,0,0.091611
4249,7B860FF4,1,0,1,0,0,0,0,0.003312
4250,7D921726,0,1,1,1,0,0,0,0
4251,75CD5415,1,2,3,0.666667,4,0,0.000035,0.003312
4252,7ED6CA8E,0,1,1,1,0,0,0,0
4253,7BB83AB9,1,0,1,0,0,0,0,0.005241
4254,7993D9FA,1,0,1,0,0,0,0,0.003312
4255,7A2E2EB1,1,5,6,0.777778,2,0,0,0.003312
4256,7CD89985,1,0,1,0,0,0,0,0.003312
4257,781BE82F,1,0,1,0,0,0,0,0.009655
4258,7E5C7B1F,1,0,1,0,0,0,0,0.003312
4259,63884ED3,1,0,1,0,0,0,0,0.003312
4260,7E3D3BC3,0,1,1,1,0,0,0,0
4261,7FCBAACE,0,1,1,1,0,0,0,0
4262,81623367,3,7,10,0.441667,104.917857,0,0,0.01242
4263,80403E93,2,0,2,0,0,0,0,0.010482
4264,780D68C6,0,1,1,1,0,0,0,0
4265,7950FA5F,2,1,3,1,1,0,0,0.011038
4266,7F3B6A71,0,2,2,0.666667,0,0,0,0
4267,7B74A466,1,0,1,0,0,0,0,0.003312
4268,7B277671,1,0,1,0,0,0,0,0.003312
4269,765E7F0F,2,0,2,0,0,0,0,0.011038
4270,773123D4,0,2,2,0.555556,0,0,0,0
4271,7F25FE7B,2,11,13,0.442623,57.75,0,0,0.006624
4272,8032F7C5,1,1,2,0.666667,0,0,0,0.003312
4273,7CFC4AD9,0,2,2,1,0,0,0.000008,0
4274,7FAB3FE7,1,0,1,0,0,0,0,0.003312
4275,78D8C384,0,4,4,1,0,0,0,0
4276,767A0D12,0,2,2,1,0,0,0,0
4277,82ECC9DD,0,2,2,1,0,0,0,0
4278,784F5C9B,1,1,2,0.310345,0.5,0,0,0.005241
4279,8139AF90,0,2,2,1,0,0,0,0
4280,7AF5E4B0,2,2,4,0.365854,29,0,0,0.006624
4281,755BE27A,0,3,3,0.625,0,0,0,0
4282,784BB003,0,5,5,0.857143,0,0,0,0
4283,79BB79F9,0,1,1,1,0,0,0,0
4284,7AC1A99E,0,1,1,1,0,0,0,0
4285,7B70828A,0,2,2,1,0,0,0,0
4286,5ED47760,0,3,3,0.375,0,0,0,0
4287,7ED126A9,0,1,1,1,0,0,0,0
4288,7F82A4CF,0,6,6,0.442308,0,0,0,0
4289,634272F4,1,0,1,0,0,0,0,0.003312
4290,804E1D5B,1,0,1,0,0,0,0,0.003312
4291,7BB91CA3,3,1,4,1,2,0,0,0.02537
4292,75EEB8C8,0,2,2,1,0,0,0,0
4293,80489278,1,0,1,0,0,0,0,0.003312
4294,7F01E505,1,1,2,1,2,0,0,0.005241
4295,76D095E0,0,2,2,1,0,0,0.040123,0
4296,7F0C8829,0,2,2,0.384615,0,0,0,0
4297,7538CD75,0,1,1,1,0,0,0,0
4298,7689A075,2,0,2,0,0,0,0,0.006624
4299,7FD60F1B,0,1,1,1,0,0,0,0
4300,7800574C,1,0,1,0,0,0.014142,0,0.0128
4301,7DF8E087,1,7,8,0.397849,45.533333,0,0,0.005241
4302,75AE6D44,2,1,3,1,1.5,0,0,0.006624
4303,7FD0CF7E,0,1,1,1,0,0,0,0
4304,796E88F1,6,0,6,0,0,0,0,0.026214
4305,7B849E44,1,5,6,0.571429,12,0,0,0.003312
4306,7AE97315,3,1,4,0.5,6.922222,0,0,0.009935
4307,7B0BE37B,0,1,1,1,0,0,0,0
4308,79336F29,0,2,2,0.75,0,0,0,0
4309,7D5C75B4,2,1,3,1,4.833333,0,0,0.016429
4310,75618A73,1,0,1,0,0,0,0,0.003312
4311,76A0736A,0,1,1,1,0,0,0,0
4312,7DC2FAF6,1,0,1,0,0,0.003859,0,0.003312
4313,79E52208,1,0,1,0,0,0,0,0.003312
4314,7681A44F,0,3,3,1,0,0,0,0
4315,75F6E632,1,0,1,0,0,0,0,0.005241
4316,80A9286C,3,0,3,0,0,0,0,0.140994
4317,7D3963A7,0,1,1,1,0,0,0,0
4318,75B5CA98,1,0,1,0,0,0,0,0.003312
4319,7D0307E4,1,0,1,0,0,0,0,0.003312
4320,75E89DAE,0,1,1,1,0,0,0,0
4321,8169C2C0,1,8,9,0.5,17,0,0,0.003312
4322,7D81ECC5,1,1,2,0.6,3,0,0,0.003312
4323,7F0A66D0,5,7,12,0.536585,67.4,0,0,0.035881
4324,75DEF455,1,0,1,0,0,0,0,0.003312
4325,7DAE0F85,0,1,1,1,0,0,0,0
4326,5CF0ACA2,0,1,1,1,0,0,0,0
4327,76B76210,1,0,1,0,0,0,0,0.003312
4328,7771A4D7,1,0,1,0,0,0,0,0.003312
4329,7EF6D5E1,5,1,6,1,10,0,0,0.033952
4330,7758F741,1,6,7,0.714286,4,0,0,0.003312
4331,7FB5F0A8,4,3,7,0.583333,36.166667,0,0,0.031737
4332,618266FA,1,0,1,0,0,0,0,0.003312
4333,5914D150,0,1,1,0.6,0,0,0,0
4334,0A376013,1,0,1,0,0,0,0,0.003312
4335,778EE99A,1,0,1,0,0,0,0,0.003312
4336,7690E564,2,6,8,0.401869,37.266667,0,0,0.006624
4337,7F0B57F7,1,0,1,0,0,0,0,0.003312
4338,7CF2C3F8,0,2,2,0.571429,0,0,0.000001,0
4339,80E0ABC8,0,1,1,1,0,0,0,0
4340,8147C29F,6,1,7,1,8.5,0,0,0.028143
4341,795D2FB4,3,0,3,0,0,0,0,0.013794
4342,76B79DF6,1,0,1,0,0,0,0,0.003312
4343,7829C90C,1,0,1,0,0,0,0,0.003312
4344,7AE43C25,3,0,3,0,0,0,0,0.035668
4345,8012E0A2,0,1,1,0.444444,0,0,0,0
4346,782F76A5,1,0,1,0,0,0,0,0.003312
4347,752795A1,2,1,3,1,2,0,0,0.006624
4348,7C93F6E6,1,0,1,0,0,0,0,0.007726
4349,78C3FF18,0,6,6,0.8,0,0,0,0
4350,80CE8E0D,1,1,2,1,0,0,0,0.005241
4351,7F347791,0,1,1,1,0,0,0,0
4352,7B5FA43D,4,0,4,0,0,0,0,0.023449
4353,7EF1C1D1,1,0,1,0,0,0,0,0.003312
4354,76B3DA6E,0,1,1,1,0,0,0,0
4355,7DC2335D,0,2,2,0.285714,0,0,0,0
4356,8163E992,0,1,1,0.666667,0,0,0,0
4357,75310D96,1,0,1,0,0,0,0,0.003312
4358,776639DA,1,0,1,0,0,0,0,0.003312
4359,76B30D46,0,1,1,0.5,0,0,0,0
4360,76B1B0BF,2,2,4,0.411765,8,0,0,0.037326
4361,7EC45738,5,0,5,0,0,0,0,0.016559
4362,7DAE4659,2,0,2,0,0,0,0,0.006624
4363,7559F099,1,0,1,0,0,0,0,0.003312
4364,58D953FA,0,2,2,1,0,0,0,0
4365,804DF3F8,0,4,4,0.571429,0,0,0,0
4366,7723567C,3,0,3,0,0,0,0,0.016121
4367,7658C947,2,0,2,0,0,0,0,0.006624
4368,7EB4D608,1,1,2,1,1,0,0,0.003312
4369,7D3F6AC4,0,1,1,0.307692,0,0,0,0
4370,7D64E0A5,1,0,1,0,0,0,0,0.005241
4371,7F41DD0E,1,3,4,0.466667,4.478571,0,0,0.020968
4372,80393556,0,3,3,1,0,0,0,0
4373,81094151,0,1,1,0.666667,0,0,0,0
4374,75B7EF1E,5,0,5,0,0,0,0,0.03173
4375,7E79797C,1,0,1,0,0,0,0,0.014625
4376,7A19C6FF,0,1,1,1,0,0,0,0
4377,7DC8706C,1,3,4,0.533333,5.666667,0,0,0.011426
4378,7C66527A,0,2,2,1,0,0,0,0
4379,810DB32F,0,3,3,0.5,0,0,0,0
4380,80B05C01,0,2,2,0.75,0,0,0,0
4381,78E9E3B7,2,2,4,0.545455,1.5,0,0,0.008553
4382,75AFC7D8,0,1,1,0.287671,0,0,0,0
4383,80952AEB,0,1,1,1,0,0,0,0
4384,76AC3AE8,0,2,2,0.432432,0,0,0,0
4385,806C1E04,6,1,7,1,15,0,0,0.034323
4386,7E5A1FEE,3,1,4,1,6,0,0,0.017653
4387,790CD5A7,8,0,8,0,0,0.000006,0,0.053639
4388,759CD7C9,1,0,1,0,0,0,0,0.003312
4389,754D92F7,0,1,1,1,0,0,0,0
4390,7DE68EEA,2,0,2,0,0,0,0,0.012967
4391,7BA20B12,0,5,5,0.529412,0,0,0,0
4392,7ABE05BC,1,0,1,0,0,0,0,0.003312
4393,7A5E011A,1,0,1,0,0,0,0,0.003312
4394,793FB68A,1,6,7,0.75,9,0,0,0.003312
4395,7F7B9D71,4,3,7,0.5,39,0,0,0.015176
4396,767BCF1D,2,0,2,0,0,0,0,0.013575
4397,79B84987,0,1,1,1,0,0,0,0
4398,75A41EB5,1,0,1,0,0,0,0,0.003312
4399,5D87510C,0,4,4,0.472222,0,0,0.000018,0
4400,771B666C,2,0,2,0,0,0,0,0.008553
4401,75E880E3,0,1,1,1,0,0,0,0
4402,7C1C189F,1,0,1,0,0,0,0,0.003312
4403,76A2191B,0,1,1,0.5,0,0,0,0
4404,7C6CA7CF,0,7,7,0.410959,0,0,0,0
4405,78DF9F1D,1,1,2,1,1,0,0,0.003312
4406,7D93244E,0,1,1,1,0,0,0,0
4407,7DF94C02,2,0,2,0,0,0,0,0.010482
4408,7A13E27C,0,2,2,1,0,0,0,0
4409,814A17A6,1,2,3,0.555556,5,0,0,0.003312
4410,7FE2B6FC,0,5,5,0.777778,0,0,0,0
4411,3189F7FB,1,0,1,0,0,0,0,0.005241
4412,802C47D5,2,6,8,0.413793,11,0,0,0.008553
4413,7FF45C47,1,0,1,0,0,0,0,0.005241
4414,7ACBFD47,1,0,1,0,0,0,0,0.003312
4415,7EF32C67,1,0,1,0,0,0,0,0.017875
4416,6CBE32B8,0,1,1,0.416667,0,0,0,0
4417,7A8195B0,1,0,1,0,0,0,0,0.003312
4418,5E9782F5,0,2,2,0.416667,0,0,0,0
4419,7ABCFA54,1,0,1,0,0,0,0,0.003312
4420,7C81FF85,1,0,1,0,0,0,0,0.005241
4421,7E0C7474,0,8,8,0.833333,0,0,0,0
4422,7C21504C,2,0,2,0,0,0,0,0.006624
4423,77E114F7,0,1,1,1,0,0,0,0
4424,81537524,1,0,1,0,0,0,0,0.003312
4425,75B29D91,2,1,3,0.434783,20,0,0,0.006624
4426,76878F44,0,1,1,1,0,0,0,0
4427,7C703A22,6,1,7,1,7,0,0,0.026214
4428,7DFD6C80,0,1,1,1,0,0,0,0
4429,794F0F7D,1,0,1,0,0,0,0,0.005796
4430,78B63C67,1,0,1,0,0,0,0,0.003312
4431,814A3529,1,1,2,1,1,0,0,0.003312
4432,7D4D3301,0,1,1,1,0,0,0,0
4433,764432FF,1,0,1,0,0,0,0,0.003312
4434,7C210EE2,0,2,2,1,0,0,0,0
4435,7EFFE5AA,0,1,1,0.666667,0,0,0,0
4436,7806CA15,0,1,1,0.666667,0,0,0,0
4437,0C8550CA,1,0,1,0,0,0,0,0.005241
4438,777921C7,3,5,8,0.4,83.583333,0,0,0.009935
4439,58DA1D69,1,0,1,0,0,0,0,0.003312
4440,7E02E0DD,1,0,1,0,0,0,0,0.003312
4441,75DBA883,0,1,1,1,0,0,0,0
4442,7D158A5E,0,1,1,1,0,0,0,0
4443,02A53EA2,1,0,1,0,0,0,0,0.003312
4444,7EA04B6A,1,0,1,0,0,0,0,0.003312
4445,801BA07F,0,1,1,1,0,0,0,0
4446,759E4B3B,0,1,1,1,0,0,0,0
4447,7E548792,1,0,1,0,0,0,0,0.003312
4448,7AB1DDC3,0,2,2,1,0,0,0,0
4449,7D3F5208,0,1,1,1,0,0,0,0
4450,78374418,2,0,2,0,0,0,0,0.010482
4451,80837A45,3,0,3,0,0,0,0,0.01242
4452,7C61CF89,0,1,1,1,0,0,0,0
4453,76F139AB,0,2,2,1,0,0,0,0
4454,7A9A27C5,0,4,4,0.5625,0,0,0,0
4455,816D7BDD,0,5,5,0.424528,0,0,0,0
4456,77E22526,1,2,3,0.75,2,0,0,0.003312
4457,7A3CFECE,0,1,1,1,0,0,0,0
4458,77535AE7,1,0,1,0,0,0,0,0.003312
4459,7FF34C17,0,2,2,1,0,0,0,0
4460,772BA13C,0,1,1,0.6,0,0,0,0
4461,814F5ABD,0,1,1,1,0,0,0,0
4462,81631D7F,0,1,1,1,0,0,0,0
4463,7EDB98EF,0,1,1,1,0,0,0,0
4464,76B5E15C,12,0,12,0,0,0,0,0.090991
4465,78F7F846,0,3,3,1,0,0,0,0
4466,7B75ABA8,0,2,2,1,0,0,0,0
4467,809300E7,1,0,1,0,0,0,0,0.003312
4468,7918EF98,0,1,1,1,0,0,0,0
4469,7B7AC097,2,0,2,0,0,0,0,0.106165
4470,774105D1,1,1,2,1,2,0,0,0.005241
4471,7AC37FDD,0,4,4,0.555556,0,0,0.038009,0
4472,80DC5183,2,1,3,0.454545,13.833333,0,0,0.008553
4473,78F25E75,1,0,1,0,0,0,0,0.003312
4474,796B3FF0,1,0,1,0,0,0,0,0.003312
4475,79D3A381,1,2,3,0.457143,5.5,0,0,0.003312
4476,59FD6E9E,0,1,1,1,0,0,0,0
4477,7D10D549,1,0,1,0,0,0,0,0.010211
4478,7F8633A7,2,1,3,1,2,0,0,0.006624
4479,756361B4,2,0,2,0,0,0,0,0.010482
4480,756846D9,0,2,2,1,0,0,0,0
4481,7DEB8403,0,2,2,1,0,0,0,0
4482,7B862388,4,2,6,1,4.5,0,0,0.029147
4483,7FB4C54D,0,1,1,1,0,0,0,0
4484,75654250,1,0,1,0,0,0,0,0.003312
4485,5D1DCB7D,3,0,3,0,0,0,0,0.014349
4486,7791DFE3,1,0,1,0,0,0,0,0.003312
4487,80129ED0,1,1,2,1,0,0,0,0.003312
4488,8150A251,0,1,1,1,0,0,0,0
4489,5B720A1B,0,3,3,0.5625,0,0,0,0
4490,8127A1EF,0,1,1,1,0,0,0,0
4491,778CD869,2,0,2,0,0,0.026542,0,0.019416
4492,7D63AF49,1,0,1,0,0,0,0,0.003312
4493,807D15F0,0,2,2,1,0,0,0,0
4494,7EF2F88D,2,0,2,0,0,0,0,0.006624
4495,8097F7B8,1,1,2,1,1,0,0,0.003312
4496,772AFD14,0,1,1,0.5,0,0,0,0
4497,7515D031,0,3,3,0.666667,0,0,0,0
4498,7ECE5726,1,0,1,0,0,0,0,0.003312
4499,7F4CE19E,0,2,2,0.75,0,0,0,0
4500,7B2C1296,1,0,1,0,0,0,0,0.003312
4501,3077357F,1,0,1,0,0,0,0,0.009602
4502,7D017CCA,1,0,1,0,0,0,0,0.003312
4503,76CCB73D,0,2,2,0.75,0,0,0,0
4504,7FC81549,0,1,1,0.6,0,0,0,0
4505,75D05FAA,2,1,3,0.666667,1,0,0,0.010482
4506,7BD407BC,0,1,1,1,0,0,0,0
4507,7EAB1453,0,1,1,1,0,0,0,0
4508,71946D73,1,3,4,0.5,0,0,0,0.003312
4509,7B62DA65,2,0,2,0,0,0,0,0.009108
4510,76DA0343,1,0,1,0,0,0,0,0.003312
4511,7AED4D12,0,10,10,0.357143,0,0,0,0
4512,75289C07,0,1,1,1,0,0,0,0
4513,02CF88B9,1,0,1,0,0,0,0,0.003312
4514,5CBEA2EF,0,1,1,1,0,0,0,0
4515,81881126,0,6,6,1,0,0,0,0
4516,81A1C44E,1,0,1,0,0,0,0,0.003312
4517,7F9A6666,5,0,5,0,0,0,0,0.022347
4518,7970E164,0,3,3,0.714286,0,0,0,0
4519,80EC705A,6,0,6,0,0,0,0,0.0218
4520,7F164E76,0,1,1,1,0,0,0.000008,0
4521,7C2D7EBC,0,2,2,0.345455,0,0,0,0
4522,6E23A9E5,1,0,1,0,0,0,0,0.007726
4523,816A7CAD,6,0,6,0,0,0,0,0.030628
4524,7E8E949E,0,1,1,0.6,0,0,0,0
4525,5F3EF7BD,1,0,1,0,0,0,0,0.003312
4526,7F46FC0C,2,0,2,0,0,0,0,0.008553
4527,7E100598,1,1,2,0.410256,16,0,0,0.003312
4528,7D3C274E,1,0,1,0,0,0,0,0.005241
4529,7D8B969E,0,4,4,0.571429,0,0,0,0
4530,8092A15E,1,0,1,0,0,0,0,0.005241
4531,750A8A33,0,2,2,1,0,0,0,0
4532,809B83BD,3,0,3,0,0,0,0,0.009935
4533,7699F905,1,0,1,0,0,0,0,0.003312
4534,8152BCCA,9,6,15,0.565217,100.333333,0,0,0.040008
4535,7EBA7EFC,3,1,4,1,5,0,0,0.023733
4536,7F80F612,0,4,4,1,0,0,0,0
4537,7AF64AF8,0,1,1,0.375,0,0,0,0
4538,802ADD96,0,2,2,0.454545,0,0,0,0
4539,79D763FB,1,0,1,0,0,0,0,0.005241
4540,7AFED264,0,2,2,0.75,0,0,0,0
4541,5D42CBEE,1,0,1,0,0,0,0,0.003312
4542,7AD74726,0,1,1,1,0,0,0,0
4543,7B2B96B1,4,3,7,0.636364,10.666667,0.063718,0.112398,0.031114
4544,7949EAE2,1,0,1,0,0,0,0,0.003312
4545,7CC68A0E,7,2,9,0.545455,14.261111,0,0,0.066421
4546,7DE6E2FE,1,4,5,0.416667,18,0.000004,0.000037,0.003312
4547,7FE40FC0,0,7,7,0.542857,0,0,0.166077,0
4548,77449830,5,0,5,0,0,0,0,0.03128
4549,7EC3E149,1,2,3,1,2,0,0,0.003312
4550,7A8D2BBD,0,1,1,1,0,0,0,0
4551,78CF44A3,0,1,1,1,0,0,0,0
4552,79B24367,0,1,1,1,0,0,0,0
4553,7FAE72C5,0,1,1,1,0,0,0,0
4554,7F476A93,12,7,19,0.403846,203.666667,0,0,0.065378
4555,7D640582,3,3,6,0.666667,26,0,0,0.014349
4556,76EA114B,0,1,1,1,0,0,0,0
4557,767D6933,3,0,3,0,0,0,0,0.009935
4558,7CCCF1D6,1,0,1,0,0,0,0,0.003312
4559,7BD2666D,0,1,1,1,0,0,0,0
4560,7FEB5ADB,0,3,3,0.8,0,0,0,0
4561,0220B677,0,4,4,0.75,0,0,0,0
4562,797814F7,0,2,2,1,0,0,0,0
4563,7D5967C2,0,2,2,0.538462,0,0,0,0
4564,79D2B7BB,1,0,1,0,0,0,0,0.003312
4565,79EBA2B6,1,0,1,0,0,0,0,0.003312
4566,7FC851C0,0,3,3,1,0,0,0,0
4567,809918E1,1,0,1,0,0,0,0,0.003312
4568,78EC5BFF,15,5,20,0.625,118.647222,0,0,0.082886
4569,76C68AB4,5,0,5,0,0,0,0,0.044306
4570,7FB21CCB,3,1,4,1,7,0,0,0.025107
4571,77848550,1,0,1,0,0,0,0,0.003312
4572,7EA8F9D8,3,6,9,0.5,195.333333,0,0,0.031503
4573,7610A48F,0,1,1,0.6,0,0,0,0
4574,7A822741,1,0,1,0,0,0,0,0.003312
4575,75AD2459,0,2,2,0.545455,0,0,0,0
4576,7ED0D493,0,1,1,1,0,0,0,0
4577,6F7E36EE,2,0,2,0,0,0,0,0.006624
4578,58A43FBD,3,0,3,0,0,0,0,0.011865
4579,80F210BB,0,2,2,0.75,0,0,0,0
4580,80E993EB,5,0,5,0,0,0,0,0.053702
4581,7DFF0768,2,0,2,0,0,0,0,0.006624
4582,7FC69680,1,3,4,1,9,0,0,0.00717
4583,7F18255C,3,1,4,1,4,0,0,0.011865
4584,7F7AD5D4,0,1,1,1,0,0,0,0
4585,7FAA22E1,1,0,1,0,0,0,0,0.003312
4586,815E20E7,0,3,3,0.446809,0,0,0,0
4587,7DB2D0DA,3,7,10,0.457627,82.833333,0,0,0.018208
4588,7C210ED1,0,1,1,1,0,0,0,0
4589,7C85EA7B,5,0,5,0,0,0,0,0.025387
4590,7FD9DF44,1,1,2,1,1,0,0,0.003312
4591,8090F068,0,1,1,1,0,0,0,0
4592,7F77CF8E,0,2,2,0.75,0,0,0,0
4593,7633366C,1,0,1,0,0,0,0,0.003312
4594,7F09B3D0,2,0,2,0,0,0,0,0.008553
4595,7AB6B05E,3,0,3,0,0,0,0,0.013794
4596,764BEAA9,0,2,2,0.75,0,0,0,0
4597,7C5DD1B4,20,0,20,0,0,0,0,0.204571
4598,7E6A6167,0,4,4,0.578947,0,0,0,0
4599,785B12F9,1,0,1,0,0,0,0,0.015285
4600,7F9698BD,1,0,1,0,0,0,0,0.003312
4601,7B5C780B,0,1,1,1,0,0,0,0
4602,7E085169,0,2,2,1,0,0,0,0
4603,7A277D6F,1,0,1,0,0,0,0,0.016659
4604,7D3497B4,0,6,6,1,0,0,0,0
4605,80960BBF,2,0,2,0,0,0,0,0.008553
4606,8441AC5C,0,1,1,0.666667,0,0,0,0
4607,75A84B59,1,0,1,0,0,0,0,0.003312
4608,76A16753,1,0,1,0,0,0,0,0.003312
4609,809F5E01,3,3,6,0.666667,24,0.000008,0,0.013794
4610,809EC145,0,1,1,1,0,0,0,0
4611,7DB94F79,1,11,12,0.469388,5,0,0,0.003312
4612,7FAFE8E3,2,0,2,0,0,0,0,0.006624
4613,7FCD2C14,0,4,4,0.75,0,0,0,0
4614,76098CC2,0,1,1,1,0,0,0,0
4615,77ACC21E,1,0,1,0,0,0,0,0.005241
4616,75E61C4D,0,2,2,1,0,0,0,0
4617,5E3896FD,0,2,2,0.75,0,0,0,0
4618,601BCD07,1,0,1,0,0,0,0,0.011532
4619,757DD04C,1,1,2,0.271739,0,0,0,0.00717
4620,7C0FE471,0,1,1,1,0,0,0,0
4621,814EC6DD,2,0,2,0,0,0.000002,0,0.008553
4622,7F0DE87F,2,0,2,0,0,0,0,0.006624
4623,8120C7C6,0,3,3,0.314286,0,0,0,0
4624,7CAAF15D,0,3,3,0.583333,0,0,0,0
4625,7999C578,1,0,1,0,0,0,0,0.003312
4626,7B297EEA,0,7,7,0.4,0,0,0,0
4627,75D1FEE6,0,1,1,1,0,0,0,0
4628,78866246,4,0,4,0,0,0,0,0.013247
4629,7D46C4E7,1,0,1,0,0,0,0,0.003312
4630,7783B1EF,1,0,1,0,0,0,0,0.003312
4631,1209C69D,2,0,2,0,0,0,0,0.011038
4632,81C3FFF4,0,1,1,1,0,0,0,0
4633,7E77E792,1,0,1,0,0,0,0,0.003312
4634,791035A9,1,0,1,0,0,0,0,0.003312
4635,7AE1104F,0,1,1,1,0,0,0,0
4636,7F348A78,0,8,8,0.9,0,0,0,0
4637,720C968B,1,0,1,0,0,0,0,0.003312
4638,7182D6B6,0,1,1,0.666667,0,0,0,0
4639,7EAE50BB,0,2,2,1,0,0,0,0
4640,7E09DD72,2,6,8,0.541667,35,0,0,0.008553
4641,7C4679D3,9,0,9,0,0,0,0,0.050607
4642,7D6BB8FA,1,0,1,0,0,0,0,0.003312
4643,7E25EBD2,1,0,1,0,0,0,0,0.003312
4644,783ABC13,1,2,3,0.382353,13,0,0,0.003312
4645,7814B3CE,1,0,1,0,0,0,0,0.003312
4646,79F168FA,0,6,6,0.590909,0,0,0,0
4647,78AFD11A,0,4,4,0.482759,0,0,0,0
4648,780B2189,0,1,1,0.666667,0,0,0,0
4649,0103C23B,6,0,6,0,0,0,0,0.033113
4650,7657820C,1,0,1,0,0,0,0,0.006534
4651,7896ACD3,0,1,1,1,0,0,0,0
4652,78AC9673,1,4,5,0.833333,5,0,0,0.003312
4653,7CB0F28F,1,0,1,0,0,0,0,0.00717
4654,5E225985,0,2,2,1,0,0,0,0
4655,7DB8A2EF,0,1,1,0.382353,0,0,0,0
4656,80D32A00,1,2,3,1,2,0,0.000002,0.003312
4657,79486D73,0,1,1,1,0,0,0,0
4658,7BB79299,0,1,1,1,0,0,0,0
4659,7FA35EAF,0,1,1,1,0,0,0,0
4660,7BEF3B75,2,0,2,0,0,0,0,0.010482
4661,7CD458A8,6,0,6,0,0,0,0,0.048404
4662,7C1DDCAF,1,0,1,0,0,0,0,0.003312
4663,80013068,0,1,1,1,0,0,0,0
4664,78B1B873,1,0,1,0,0,0,0,0.005241
4665,7D036F97,1,0,1,0,0,0,0,0.003312
4666,7654F7C5,3,0,3,0,0,0,0,0.009935
4667,812E2497,0,2,2,1,0,0,0,0
4668,7997F2AA,1,0,1,0,0,0,0,0.003312
4669,7509B76B,0,1,1,1,0,0,0,0
4670,800F0B8B,1,0,1,0,0,0,0,0.003312
4671,63D0E119,1,0,1,0,0,0,0,0.005241
4672,79C4E514,7,1,8,0.4,16.3,0,0,0.122049
4673,7DE42F7E,5,1,6,1,12,0,0,0.034876
4674,78FC54C9,0,1,1,1,0,0,0,0
4675,7988CF05,0,1,1,0.5,0,0,0,0
4676,7A5D5FFD,2,0,2,0,0,0,0,0.012967
4677,7F016C34,0,3,3,0.349727,0,0,0,0
4678,7FD63964,2,1,3,0.666667,3,0,0,0.006624
4679,7A7A0F50,0,3,3,0.533333,0,0,0,0
4680,7FA17194,1,0,1,0,0,0,0,0.003312
4681,773845B7,1,0,1,0,0,0,0,0.003312
4682,7932F4B7,0,2,2,0.538462,0,0,0,0
4683,7635AB5B,1,0,1,0,0,0,0,0.005241
4684,76D8DDDA,1,0,1,0,0,0,0,0.003312
4685,7E860649,0,6,6,0.75,0,0,0,0
4686,62289D6B,0,3,3,0.8,0,0,0,0
4687,77BB12ED,0,2,2,1,0,0,0,0
4688,80323362,2,1,3,1,1.5,0,0,0.006624
4689,7939E2E5,0,3,3,0.583333,0,0,0,0
4690,80F9561F,1,3,4,0.314286,30.5,0,0,0.003312
4691,7A2B8581,0,1,1,1,0,0,0,0
4692,7D85627A,1,6,7,0.714286,8.166667,0,0,0.003312
4693,7B097E04,1,0,1,0,0,0,0,0.003312
4694,769D2E8B,1,0,1,0,0,0,0,0.003312
4695,7588C6BD,2,0,2,0,0,0,0,0.006624
4696,795660F5,1,0,1,0,0,0,0,0.005241
4697,78DA6E65,0,1,1,1,0,0,0,0
4698,7D78E148,2,3,5,0.533333,40,0,0,0.009664
4699,810DE850,0,1,1,1,0,0,0,0
4700,6DF062B2,0,2,2,0.625,0,0,0,0
4701,58E20940,0,1,1,1,0,0,0,0
4702,7E4F6C81,1,2,3,1,2,0,0,0.003312
4703,79C3E12A,1,0,1,0,0,0,0,0.003312
4704,5F3F4D95,1,0,1,0,0,0,0,0.003312
4705,76681567,0,2,2,1,0,0,0,0
4706,7C037FAC,0,1,1,1,0,0,0,0
4707,7A47AE84,0,3,3,0.666667,0,0,0.000006,0
4708,80578BD3,0,2,2,0.625,0,0,0,0
4709,8013A3C9,0,2,2,0.6,0,0,0,0
4710,78BA89C3,1,1,2,1,1,0,0,0.003312
4711,7711C41B,0,3,3,0.714286,0,0,0,0
4712,7F2FDED6,1,3,4,0.458333,11,0,0,0.003312
4713,8040484B,1,0,1,0,0,0,0,0.003312
4714,7BB2195A,0,2,2,0.666667,0,0,0,0
4715,7A7E7A39,3,0,3,0,0,0,0,0.009935
4716,7D98D911,2,0,2,0,0,0,0,0.006624
4717,8146FBB6,3,2,5,0.75,17.166667,0,0,0.026489
4718,7E93D224,0,3,3,0.714286,0,0,0,0
4719,7CEC571C,1,0,1,0,0,0,0,0.003312
4720,80AE9134,3,1,4,1,3,0,0,0.009935
4721,7C0C84E9,1,0,1,0,0,0,0,0.003312
4722,7F6BE3F9,0,3,3,0.5625,0,0,0,0
4723,77A2BD81,2,0,2,0,0,0,0,0.010482
4724,75E38CD2,2,1,3,1,2,0,0,0.006624
4725,76920C2D,1,0,1,0,0,0,0,0.009655
4726,7AC18D75,1,2,3,0.75,1,0,0,0.003312
4727,77B3000B,1,4,5,0.833333,0,0,0,0.010871
4728,7E0DA5CA,1,0,1,0,0,0,0,0.003312
4729,7DCAF6B4,0,1,1,1,0,0,0,0
4730,7C275DA6,0,1,1,1,0,0,0,0
4731,622FCE77,1,0,1,0,0,0,0,0.003312
4732,776B8843,1,0,1,0,0,0,0,0.017215
4733,7FF06492,1,4,5,0.4125,5.5,0,0,0.003312
4734,7CDB4D43,2,0,2,0,0,0,0,0.008553
4735,80E6B416,3,0,3,0,0,0,0,0.011865
4736,7F24D77D,1,0,1,0,0,0,0,0.003312
4737,7D51AC4C,0,1,1,1,0,0,0,0
4738,7F22DAE8,0,1,1,1,0,0,0,0
4739,7E96EEFC,4,0,4,0,0,0,0,0.013247
4740,6D8E763B,5,0,5,0,0,0.003571,0,0.026206
4741,7A161D0C,0,2,2,0.625,0,0,0,0
4742,7991A8D0,0,2,2,1,0,0,0,0
4743,5C4082CC,0,1,1,0.5,0,0,0,0
4744,7CA321BB,1,0,1,0,0,0,0,0.003312
4745,80BBC652,1,0,1,0,0,0,0,0.003312
4746,75D7E4A2,2,2,4,0.75,15.5,0.037707,0.034168,0.01922
4747,7710C363,0,1,1,1,0,0,0,0
4748,7F8C99FC,0,2,2,1,0,0,0,0
4749,7F81381A,1,0,1,0,0,0,0,0.003312
4750,80192B41,0,1,1,0.5,0,0,0,0
4751,79C30FB6,0,1,1,1,0,0,0,0
4752,7F052660,0,3,3,1,0,0,0,0
4753,78BBBDEC,0,1,1,1,0,0,0,0
4754,7882C4AE,2,0,2,0,0,0,0,0.008553
4755,76D3D815,1,0,1,0,0,0,0,0.003312
4756,7A50443A,3,0,3,0,0,0,0,0.016279
4757,7D80DD01,7,6,13,0.392157,61.5,0,0,0.033121
4758,76B05EC9,1,0,1,0,0,0,0,0.003312
4759,7A680AF5,1,0,1,0,0,0,0,0.003312
4760,8074B8FC,2,4,6,0.5,21.5,0,0,0.006624
4761,61726815,1,0,1,0,0,0,0,0.005241
4762,79C39EA0,1,0,1,0,0,0,0,0.005241
4763,81374386,0,1,1,1,0,0,0,0
4764,5FAD02CF,0,1,1,1,0,0,0,0
4765,79EB6F18,1,0,1,0,0,0,0,0.003312
4766,7A40D56E,1,0,1,0,0,0,0,0.003312
4767,7C200B16,0,1,1,1,0,0,0,0
4768,80ED3587,2,2,4,0.411765,8.333333,0,0,0.008553
4769,5A55D907,0,5,5,0.514286,0,0,0,0
4770,7E1D5DB4,0,1,1,1,0,0,0,0
4771,80C2E523,1,9,10,0.528302,19.433333,0.02085,0.132298,0.003312
4772,7739F9BC,1,0,1,0,0,0,0,0.003312
4773,7E6D4193,0,1,1,1,0,0,0,0
4774,7A2C15B1,2,0,2,0,0,0,0,0.006624
4775,75E031BE,1,0,1,0,0,0,0,0.003312
4776,75C75999,1,0,1,0,0,0,0,0.007726
4777,77021932,0,2,2,0.461538,0,0,0,0
4778,76D86B2A,2,3,5,0.565217,10,0,0,0.008553
4779,7DA968CD,1,0,1,0,0,0,0,0.003312
4780,81667ACA,1,1,2,1,1,0,0,0.003312
4781,7F595101,1,0,1,0,0,0,0,0.003312
4782,7F0983F7,1,0,1,0,0,0,0,0.003312
4783,80F43345,3,2,5,1,5,0.000001,0.000366,0.009935
4784,7BE6A22B,2,0,2,0,0,0,0,0.008553
4785,7C9971DA,2,0,2,0,0,0,0,0.012412
4786,7D558045,4,0,4,0,0,0,0,0.013247
4787,79EA80E6,0,1,1,0.444444,0,0,0,0
4788,770EFCDF,1,0,1,0,0,0,0,0.003312
4789,7F0B2DF8,0,3,3,0.529412,0,0,0,0
4790,6E78522F,1,0,1,0,0,0,0,0.016329
4791,7E8FFC29,0,2,2,0.75,0,0,0,0
4792,809748E2,1,15,16,0.705882,19.166667,0,0.000044,0.003312
4793,7929394E,2,0,2,0,0,0,0,0.006624
4794,8003BE7F,1,0,1,0,0,0,0,0.003312
4795,7F7682DB,0,1,1,0.375,0,0,0,0
4796,802EAF43,1,3,4,1,3,0,0,0.003312
4797,7645DBC1,2,0,2,0,0,0,0,0.015294
4798,777DB35C,0,2,2,1,0,0,0,0
4799,76D888E7,1,2,3,0.666667,0.5,0,0.000002,0.003312
4800,7832D60D,0,2,2,1,0,0,0,0
4801,7B8B07D4,1,0,1,0,0,0,0,0.033283
4802,7ECE538C,1,1,2,0.4375,7,0,0,0.003312
4803,7ADC53D6,1,0,1,0,0,0,0,0.003312
4804,77E28D44,0,1,1,0.368421,0,0,0,0
4805,76D0F2C6,0,2,2,0.555556,0,0,0,0
4806,80F19EA3,0,2,2,0.75,0,0,0,0
4807,7946682E,1,0,1,0,0,0,0,0.003312
4808,80EAB41D,0,3,3,1,0,0,0,0
4809,7B3F0013,0,3,3,0.358491,0,0,0,0
4810,7DE1F7A8,1,4,5,0.5,13,0,0,0.003312
4811,8059433A,0,1,1,1,0,0,0,0
4812,7534190D,1,0,1,0,0,0,0,0.003312
4813,7B889C4C,2,0,2,0,0,0,0,0.010482
4814,79DF2EC8,1,0,1,0,0,0,0,0.005241
4815,765EE356,1,0,1,0,0,0.02085,0,0.003312
4816,7C36F41F,0,1,1,1,0,0,0,0
4817,77B901C6,3,0,3,0,0,0,0,0.011865
4818,78801E55,4,0,4,0,0,0,0,0.101211
4819,7A422A3C,1,0,1,0,0,0,0,0.003312
4820,7AFDBF1B,5,0,5,0,0,0.000009,0,0.035589
4821,801D2F23,1,6,7,0.435897,16,0,0,0.003312
4822,7EE96817,0,3,3,0.714286,0,0,0,0
4823,5C2564B7,0,1,1,1,0,0,0,0
4824,7FEE6AB7,0,1,1,1,0,0,0,0
4825,8091C168,0,1,1,0.338028,0,0,0,0
4826,803B7097,5,2,7,0.625,21.166667,0,0,0.041219
4827,590571F2,0,1,1,1,0,0,0.000001,0
4828,807EB561,0,1,1,0.4,0,0,0,0
4829,7C8B8698,3,0,3,0,0,0,0,0.038484
4830,759B3482,3,0,3,0,0,0,0,0.019424
4831,01D2D344,1,0,1,0,0,0,0,0.005241
4832,7DD8FA27,2,0,2,0,0,0,0,0.006624
4833,7BD01299,0,3,3,0.472222,0,0,0,0
4834,7FB1C510,0,3,3,1,0,0,0,0
4835,7878C2E5,0,1,1,1,0,0,0,0
4836,63039336,3,0,3,0,0,0,0,0.009935
4837,7F6DAED9,0,1,1,0.666667,0,0,0,0
4838,7A435F2A,1,1,2,1,1,0,0,0.003312
4839,7D3C0274,0,1,1,0.414286,0,0,0,0
4840,76DCBCE0,0,2,2,1,0,0,0,0
4841,76D47AF8,0,1,1,1,0,0,0,0
4842,78442E7E,1,0,1,0,0,0,0,0.003312
4843,7B37C0D9,0,1,1,1,0,0,0,0
4844,7D9076CD,2,2,4,0.5,12,0,0,0.006624
4845,7C477926,0,2,2,1,0,0,0,0
4846,7D62B9CE,0,1,1,1,0,0,0,0
4847,788FE82C,1,0,1,0,0,0,0,0.003312
4848,80998289,1,3,4,0.538462,9.5,0,0,0.005241
4849,7F120A09,0,1,1,1,0,0,0,0
4850,7DC886EC,0,4,4,0.833333,0,0,0,0
4851,08BFA50B,0,1,1,0.416667,0,0,0.000002,0
4852,7E2099BE,1,1,2,0.391304,8,0,0,0.005241
4853,7F646BC8,6,1,7,1,3.5,0,0,0.044531
4854,7B9501D9,1,0,1,0,0,0,0,0.038822
4855,80FAB433,0,1,1,0.6,0,0,0,0
4856,777EAFAD,1,0,1,0,0,0,0,0.005241
4857,7B7A5001,1,0,1,0,0,0,0,0.003312
4858,7CB4C968,0,2,2,0.421053,0,0,0,0
4859,7A5C8006,4,0,4,0,0,0,0,0.015176
4860,7D37BA45,0,1,1,1,0,0,0,0
