Id,Label,indegree,outdegree,Degree,closnesscentrality,betweenesscentrality,Authority,Hub,eigencentrality
0,5F7D28BA,0,1,1,1,0,0,0.008153,0
1,7D59F50D,1,0,1,0,0,0.000014,0,0.005831
2,096FE627,1,0,1,0,0,0.021408,0,0.005831
3,7DB4EBA8,0,2,2,0.75,0,0,0.0354,0
4,7836AAFD,5,0,5,0,0,0.000008,0,0.106803
5,8069AB34,1,0,1,0,0,0,0,0.005831
6,7E07E299,0,2,2,0.428571,0,0,0.002304,0
7,7E118CA8,6,0,6,0,0,0,0,0.06134
8,75464F4C,2,4,6,0.615385,31,0.019087,0.002012,0.024839
9,777094E3,0,2,2,1,0,0,0.001077,0
10,7BA04FD7,0,4,4,0.6,0,0,0.143521,0
11,7ECAD363,1,1,2,1,1,0.000046,0,0.005831
12,7884D32C,1,0,1,0,0,0,0,0.012419
13,5C27E998,0,1,1,1,0,0,0.053089,0
14,792D9D58,0,1,1,1,0,0,0.000026,0
15,7D0C5ACF,1,1,2,1,0,0.005173,0.001496,0.10488
16,7E0B900D,0,1,1,1,0,0,0,0
17,7CF993B1,0,1,1,1,0,0,0,0
18,7EC63C26,1,0,1,0,0,0,0,0.005831
19,80F62DFD,0,1,1,1,0,0,0.11276,0
20,5D25C398,0,1,1,1,0,0,0,0
21,7D871529,0,2,2,1,0,0,0.055435,0
22,761765E7,0,1,1,1,0,0,0.000927,0
23,7B55219F,0,1,1,1,0,0,0.008153,0
24,777A9444,2,0,2,0,0,0,0,0.011663
25,7EB79B6F,0,2,2,1,0,0,0.00532,0
26,76121E5E,0,4,4,0.4,0,0,0.010317,0
27,5CA383D7,1,1,2,0.5,0,0.000277,0.001824,0.026364
28,81051DE1,1,3,4,0.714286,5,0,0.010166,0.005831
29,7D6BF95F,2,2,4,0.461538,11,0.001086,0.001859,0.05196
30,7C659FCA,0,1,1,0.571429,0,0,0.024823,0
31,7F17EEC7,0,1,1,1,0,0,0.002213,0
32,7FED3D97,0,2,2,0.508475,0,0,0.012315,0
33,75296F78,1,0,1,0,0,0,0,0.032952
34,5DA11B90,1,0,1,0,0,0,0,0.005831
35,76B1BFA3,0,8,8,0.407692,0,0,0.001887,0
36,7B82906A,2,0,2,0,0,0.008591,0,0.011663
37,7BD76242,0,2,2,0.5625,0,0,0.00673,0
38,583CC201,27,0,27,0,0,0.102309,0,0.290298
39,7C84D570,0,1,1,1,0,0,0,0
40,0AD0EFF2,1,0,1,0,0,0.000801,0,0.005831
41,5B21D4DB,0,2,2,0.666667,0,0,0,0
42,7A5B0A16,1,3,4,0.36,0,0,0,0.005831
43,07CF004C,0,1,1,0.666667,0,0,0,0
44,7F617EA0,0,1,1,0.444444,0,0,0,0
45,76E46C09,0,2,2,1,0,0,0.005965,0
46,5ADB4B1F,1,0,1,0,0,0.003984,0,0.005831
47,7EFAF191,6,0,6,0,0,0,0,0.06134
48,7A917624,0,1,1,1,0,0,0,0
49,7D6B33E0,1,1,2,1,0,0.000006,0.000002,0.005831
50,5D23F78F,0,1,1,0.416667,0,0,0.000932,0
51,7DF0B2B7,0,1,1,1,0,0,0.000001,0
52,7B0D80E7,0,1,1,0.5,0,0,0,0
53,75EE81A9,6,1,7,1,8,0.013299,0,0.048164
54,760DA458,0,1,1,1,0,0,0.005172,0
55,5DEEAA12,1,0,1,0,0,0.00021,0,0.019007
56,7F6EAC0E,0,1,1,1,0,0,0,0
57,7FD6CCB1,1,0,1,0,0,0,0,0.005831
58,7A5783B7,2,0,2,0,0,0.007582,0,0.011663
59,5BD2E015,0,3,3,0.5,0,0,0.002588,0
60,7A075B5B,2,2,4,0.666667,7,0,0,0.011663
61,7027A8E1,5,0,5,0,0,0.000724,0,0.029156
62,7F13DCEC,0,2,2,1,0,0,0.00831,0
63,712B8105,1,0,1,0,0,0,0,0.005831
64,7783A7FC,1,0,1,0,0,0,0,0.005831
65,7CE9A083,0,1,1,1,0,0,0.11276,0
66,7624A8EF,1,0,1,0,0,0,0,0.005831
67,7A6F854E,0,4,4,0.666667,0,0,0.045862,0
68,7ED0BE26,0,3,3,0.484848,0,0,0.0055,0
69,7FCCD98B,0,2,2,1,0,0,0.120636,0
70,7C538C03,2,1,3,1,2,0.007997,0,0.011663
71,7942BB92,0,2,2,1,0,0,0.003021,0
72,0972561F,0,2,2,0.75,0,0,0.0354,0
73,79249A4C,0,1,1,0.347826,0,0,0,0
74,7F502558,0,1,1,1,0,0,0.005219,0
75,7C09F4A8,0,2,2,0.419355,0,0,0,0
76,7C035BC6,2,0,2,0,0,0.002491,0,0.011663
77,58ECEC8C,1,0,1,0,0,0,0,0.005831
78,78C5A77A,2,0,2,0,0,0.007182,0,0.011663
79,7DA7A9A2,0,1,1,0.533333,0,0,0.004674,0
80,7CEB4D0E,2,2,4,0.5625,13.5,0.003056,0.012551,0.011663
81,8102A209,1,1,2,1,1.5,0.000149,0.11276,0.049038
82,7F08D85D,0,1,1,1,0,0,0,0
83,130BCCF7,2,0,2,0,0,0.000261,0,0.011663
84,7B39BBCF,0,2,2,1,0,0,0.054131,0
85,78BE6513,0,1,1,0.454545,0,0,0,0
86,7EF8C984,0,1,1,0.666667,0,0,0.000124,0
87,7E18273D,1,0,1,0,0,0.000731,0,0.005831
88,63884C1D,3,0,3,0,0,0.000775,0,0.017494
89,781218D5,1,4,5,0.6,1.083333,0.006487,0.068061,0.005831
90,7DD9AB9A,1,2,3,0.75,5,0.00085,0.003344,0.012419
91,7A2505E4,0,3,3,0.714286,0,0,0.003143,0
92,7808D939,4,0,4,0,0,0.000827,0,0.046768
93,78D9D4E6,2,0,2,0,0,0.003307,0,0.028517
94,5E84EE11,0,1,1,1,0,0,0.000265,0
95,75AD64AE,0,3,3,0.8,0,0,0.061581,0
96,7F8DA76A,0,1,1,0.428571,0,0,0.001146,0
97,60925BB1,1,0,1,0,0,0.000277,0,0.026364
98,7918E6DE,0,1,1,1,0,0,0,0
99,5F70E1A4,2,1,3,1,2,0,0.005219,0.018251
100,815EC122,2,0,2,0,0,0,0,0.011663
101,5D2614D0,0,2,2,0.625,0,0,0.003277,0
102,7F2CCD5E,2,3,5,0.8,8.5,0.018527,0.006444,0.018251
103,76379AE0,0,1,1,1,0,0,0,0
104,794A8342,1,0,1,0,0,0.000187,0,0.005831
105,7940B4A1,1,0,1,0,0,0,0,0.005831
106,75365D9D,1,0,1,0,0,0,0,0.005831
107,81531AA1,3,0,3,0,0,0,0,0.017494
108,814BD334,0,6,6,0.565217,0,0,0.010133,0
109,80D6B343,1,3,4,0.428571,12,0,0.01768,0.005831
110,5A9C3896,0,1,1,0.4,0,0,0,0
111,78FC7157,0,3,3,0.236264,0,0,0.000933,0
112,79931D06,3,4,7,0.459459,20.5,0.002206,0.01329,0.034348
113,7B3DD8D0,3,0,3,0,0,0,0,0.017494
114,7E5562F9,1,3,4,0.636364,7,0.000204,0.055684,0.005831
115,5F266F4C,0,1,1,1,0,0,0,0
116,7985A140,0,2,2,0.444444,0,0,0.01139,0
117,76F222A0,0,5,5,0.52381,0,0,0,0
118,76A2AE78,1,0,1,0,0,0,0,0.005831
119,5FC3D117,0,1,1,1,0,0,0.01406,0
120,5DE0814F,0,1,1,0.533333,0,0,0.004674,0
121,7FAA4BA9,0,2,2,1,0,0,0.000127,0
122,794E38C5,1,0,1,0,0,0.000006,0,0.005831
123,7B33A4AD,0,1,1,0.368421,0,0,0,0
124,766E5517,0,3,3,1,0,0,0.013313,0
125,7C54DFE0,0,3,3,0.538462,0,0,0.131366,0
126,7F7E8785,1,1,2,1,0,0.001649,0.008153,0.005831
127,560B2421,0,3,3,0.360656,0,0,0.000607,0
128,7C9D2136,1,2,3,0.666667,2,0,0,0.012419
129,79A5978B,1,0,1,0,0,0.000317,0,0.113712
130,80BE6F3A,0,1,1,1,0,0,0.0001,0
131,5B7F5483,0,1,1,1,0,0,0,0
132,7A155A0A,1,2,3,0.75,2,0,0,0.005831
133,75FAFF35,0,6,6,0.8,0,0,0.032301,0
134,7EAAD3A1,0,3,3,0.666667,0,0,0.003395,0
135,7A88004A,0,1,1,1,0,0,0.01406,0
136,75E5F770,2,0,2,0,0,0.000323,0,0.139308
137,7A3E6E74,0,1,1,0.5,0,0,0,0
138,5EA0BB7C,0,2,2,0.5625,0,0,0.004858,0
139,80F25EF4,0,1,1,0.428571,0,0,0.001146,0
140,7F05797A,2,0,2,0,0,0,0,0.011663
141,7F272634,1,1,2,0.40625,5,0.000668,0.000003,0.005831
142,7A18D63D,5,0,5,0,0,0.007691,0,0.390868
143,7B4448DF,1,0,1,0,0,0,0,0.005831
144,80F0F8E4,0,1,1,1,0,0,0,0
145,7E4B0309,1,0,1,0,0,0,0,0.005831
146,689FA895,20,0,20,0,0,0.037635,0,0.216196
147,79406A62,0,2,2,0.195455,0,0,0.01433,0
148,7FDDD447,2,1,3,0.571429,8,0,0.001441,0.011663
149,7EEF3736,1,2,3,1,3.5,0.002922,0.001078,0.012419
150,800CEA3E,0,1,1,1,0,0,0.01406,0
151,77B5357E,3,0,3,0,0,0.002095,0,0.017494
152,781D1964,2,0,2,0,0,0,0,0.041693
153,80D8BC42,0,1,1,1,0,0,0,0
154,772BA939,1,0,1,0,0,0,0,0.012419
155,7E308670,2,3,5,0.8,8,0,0.000039,0.011663
156,758F58B5,0,2,2,0.75,0,0,0,0
157,59E014F7,1,1,2,1,1,0,0.000845,0.005831
158,7515C5E1,0,1,1,1,0,0,0.000379,0
159,013A562B,2,0,2,0,0,0,0,0.018251
160,7EAEC660,1,0,1,0,0,0.000256,0,0.005831
161,8043E4F8,0,3,3,0.8,0,0,0.011998,0
162,7DD171A0,5,4,9,0.366337,561.833333,0.005608,0.001578,0.169977
163,7B6C0DF2,3,0,3,0,0,0.000154,0,0.065148
164,7BCEB81E,1,0,1,0,0,0.000017,0,0.005831
165,7C8CCCB4,1,5,6,0.375,3.5,0.000083,0.001855,0.005831
166,7FF8481B,0,2,2,1,0,0,0.008223,0
167,59F961F6,15,4,19,0.666667,114,0.008337,0.028992,0.107233
168,81702C53,0,1,1,1,0,0,0.11276,0
169,5AC679FE,0,2,2,0.545455,0,0,0.054913,0
170,76957AB8,0,3,3,0.666667,0,0,0.000336,0
171,79006A5D,0,1,1,1,0,0,0.000959,0
172,808C8578,0,5,5,0.482759,0,0,0.019596,0
173,816302E5,0,2,2,1,0,0,0,0
174,7EB1ED43,0,1,1,0.666667,0,0,0,0
175,7D014A76,0,5,5,0.692308,0,0,0.161166,0
176,7D1C6266,1,0,1,0,0,0,0,0.005831
177,7E90A831,5,5,10,0.631579,60.5,0.000023,0.007752,0.042332
178,7E842BBC,2,0,2,0,0,0.000999,0,0.04905
179,60D65F09,0,1,1,0.6,0,0,0.000042,0
180,5C0E3543,0,1,1,0.428571,0,0,0.001146,0
181,7C1A5149,0,1,1,1,0,0,0,0
182,8018720D,2,0,2,0,0,0,0,0.011663
183,6CD42980,1,0,1,0,0,0.003477,0,0.005831
184,75548498,2,0,2,0,0,0.020279,0,0.041693
185,6BEA8553,0,1,1,1,0,0,0,0
186,7EB7DA8D,0,1,1,0.392857,0,0,0.010605,0
187,7903B636,0,1,1,1,0,0,0.000725,0
188,7772B19F,3,1,4,1,3,0.001684,0.000659,0.017494
189,7B87FC6C,1,1,2,1,4,0.001987,0.11276,0.025595
190,7D0BF9C5,1,0,1,0,0,0,0,0.005831
191,7BEAD898,0,1,1,0.428571,0,0,0.001146,0
192,79479AC6,0,1,1,0.6,0,0,0,0
193,7B6320CD,1,0,1,0,0,0,0,0.005831
194,7E36C31B,0,1,1,1,0,0,0,0
195,79872E33,0,1,1,1,0,0,0,0
196,7B7B920A,1,0,1,0,0,0,0,0.005831
197,7807020D,4,2,6,0.75,6.25,0.02716,0.009929,0.046768
198,7C60ABB9,1,0,1,0,0,0.005173,0,0.10488
199,7FB04BF9,6,1,7,0.571429,16.5,0.006781,0.001441,0.174899
200,7635766D,1,3,4,1,0,0.000007,0.000003,0.012419
201,5AC346D7,0,1,1,0.571429,0,0,0.024823,0
202,7E8F41FE,0,1,1,1,0,0,0,0
203,5DAC4631,1,1,2,0.666667,2,0.00201,0,0.005831
204,7745DFE0,0,2,2,0.545455,0,0,0.001961,0
205,7CAC6D54,1,0,1,0,0,0,0,0.005831
206,7B7B8A67,1,3,4,0.8,2,0.001418,0.003919,0.005831
207,7AC8DFCB,0,3,3,0.666667,0,0,0.051525,0
208,7E8510CE,2,0,2,0,0,0,0,0.011663
209,775E424E,4,1,5,1,4,0.000902,0.000004,0.029913
210,7BBB505B,2,0,2,0,0,0.00193,0,0.062226
211,78A47E05,6,0,6,0,0,0.016822,0,0.034988
212,7E5616F1,2,0,2,0,0,0,0,0.018251
213,7E1B2E88,0,1,1,0.666667,0,0,0,0
214,7F2DDA1D,4,1,5,1,0.5,0,0,0.036501
215,7907860E,0,6,6,0.52381,0,0,0.019675,0
216,5FDDEEC1,2,0,2,0,0,0,0,0.024839
217,7AF7A6E5,3,1,4,1,0,0.000008,0.000001,0.056234
218,7AC65706,0,3,3,1,0,0,0,0
219,75AC3F8B,0,1,1,1,0,0,0.000622,0
220,7C9B7793,2,1,3,1,0,0.000794,0.000114,0.018251
221,7CC7B73F,0,1,1,0.666667,0,0,0,0
222,5FB7FDCD,2,0,2,0,0,0,0,0.031427
223,7DACB0B9,1,5,6,0.777778,6,0.000259,0.000043,0.005831
224,809D1AC2,11,0,11,0,0,0,0,0.213306
225,7AED0C83,1,0,1,0,0,0,0,0.005831
226,7A7B2BA9,1,3,4,0.6,5,0.000206,0.007047,0.005831
227,7AE8A09A,0,1,1,1,0,0,0.001042,0
228,79EEF106,0,1,1,0.6,0,0,0.000042,0
229,5D04D366,1,2,3,0.555556,0,0.000801,0.002515,0.005831
230,5E6C32AB,3,1,4,1,3,0.002607,0.008153,0.024082
231,5CED5F34,13,0,13,0,0,0.008821,0,0.172486
232,76CDF761,0,3,3,1,0,0,0,0
233,7E5791EC,4,0,4,0,0,0.000026,0,0.059944
234,0BD455E8,1,1,2,1,1,0,0,0.005831
235,7518D8AB,0,2,2,0.75,0,0,0,0
236,80DA4044,1,1,2,1,2,0.000007,0.053089,0.012419
237,3414DC80,0,5,5,0.463415,0,0,0.013529,0
238,75527D59,0,1,1,0.227778,0,0,0.000897,0
239,78C404F5,0,1,1,0.5,0,0,0,0
240,5C636122,1,0,1,0,0,0.005173,0,0.10488
241,7CCB323B,0,1,1,1,0,0,0.11276,0
242,01BEAE0D,2,0,2,0,0,0.005272,0,0.110711
243,7806276E,0,6,6,0.45614,0,0,0.15639,0
244,7C879F8B,0,1,1,0.571429,0,0,0.024823,0
245,7B8BBF02,0,1,1,1,0,0,0.000029,0
246,7F3CE23A,20,0,20,0,0,0.03798,0,0.712979
247,7813E81C,1,2,3,0.625,5,0,0.025797,0.005831
248,76BBB220,1,2,3,0.346154,0.5,0.008134,0.116135,0.005831
249,5E468D72,0,1,1,1,0,0,0.001212,0
250,7987EFAC,15,0,15,0,0,0.037733,0,0.225354
251,7A16DEDE,3,1,4,1,3.5,0.001317,0.005172,0.047524
252,6F622FCF,3,1,4,1,2,0,0,0.017494
253,8088BCB1,0,1,1,1,0,0,0,0
254,7644FCFD,1,4,5,0.206897,46,0.000001,0.000234,0.005831
255,803F343B,0,4,4,1,0,0,0.014084,0
256,6CB9CCA2,0,1,1,1,0,0,0.053089,0
257,0A511FA7,0,1,1,1,0,0,0,0
258,7FB38937,0,1,1,1,0,0,0.002937,0
259,78B221C1,0,1,1,1,0,0,0.001212,0
260,7C8F5460,1,1,2,1,1,0,0,0.005831
261,7EDFB3A5,4,0,4,0,0,0.000139,0,0.043089
262,690C63DE,0,4,4,1,0,0,0.069051,0
263,7C2D70CB,1,7,8,0.75,9,0,0,0.005831
264,58DC3966,0,1,1,1,0,0,0.005219,0
265,7E21AB11,0,2,2,0.75,0,0,0.001864,0
266,09F47932,16,2,18,0.75,46.5,0.01186,0.002361,0.253282
267,800B30B3,5,0,5,0,0,0,0,0.029156
268,81736796,0,1,1,0.454545,0,0,0,0
269,77761D6E,0,1,1,0.273381,0,0,0.000771,0
270,7E4C2F0A,6,0,6,0,0,0.000188,0,0.041576
271,7886F4AE,1,0,1,0,0,0.00085,0,0.012419
272,7FDF2C7C,0,1,1,1,0,0,0.002636,0
273,76DE6639,4,0,4,0,0,0.006749,0,0.458516
274,76E7C192,1,3,4,0.666667,2,0.003546,0.026061,0.005831
275,7FA8663B,0,1,1,0.5,0,0,0.001824,0
276,79046D26,2,1,3,1,0,0,0,0.018251
277,7F293779,0,1,1,1,0,0,0,0
278,812B8C6C,2,4,6,0.7,6,0.006647,0.033924,0.011663
279,7E84B055,0,2,2,0.444444,0,0,0.115018,0
280,7D28B480,0,1,1,1,0,0,0,0
281,5D15CA29,1,0,1,0,0,0.018053,0,0.005831
282,81727861,0,1,1,1,0,0,0,0
283,7ED25D03,0,1,1,1,0,0,0.008153,0
284,7D13BEA7,0,2,2,1,0,0,0.008185,0
285,7A6DB348,1,0,1,0,0,0.001846,0,0.005831
286,763A2966,1,0,1,0,0,0.001969,0,0.026364
287,00D8E521,1,2,3,0.466667,7,0,0.014146,0.005831
288,7E88265E,2,0,2,0,0,0,0,0.011663
289,7AF23130,0,1,1,1,0,0,0.000038,0
290,7D3727BA,13,0,13,0,0,0.000017,0,0.23401
291,80975818,0,1,1,0.555556,0,0,0.001523,0
292,769FD407,1,0,1,0,0,0,0,0.005831
293,7DC08B34,0,1,1,1,0,0,0,0
294,5E5D0895,0,2,2,0.448276,0,0,0.000152,0
295,76C92EA9,1,1,2,0.666667,2,0,0.000445,0.005831
296,690E8ABF,1,0,1,0,0,0.000668,0,0.005831
297,066840FF,0,1,1,0.5,0,0,0,0
298,80D812E0,0,1,1,1,0,0,0.005172,0
299,584F8649,0,2,2,0.666667,0,0,0.077912,0
300,78F86526,2,0,2,0,0,0.00225,0,0.011663
301,7C9BAD2C,1,0,1,0,0,0.000006,0,0.005831
302,7B0730C2,0,1,1,1,0,0,0,0
303,7554B23E,1,1,2,1,1,0,0,0.005831
304,7BA827F1,1,1,2,1,0,0.005173,0.001061,0.10488
305,05D1C973,0,1,1,1,0,0,0,0
306,797B8E0C,0,1,1,1,0,0,0.002584,0
307,81508024,16,1,17,1,10.333333,0.158326,0.008938,0.414227
308,6DB6C639,0,2,2,0.461538,0,0,0,0
309,77111D18,1,0,1,0,0,0,0,0.005831
310,7AE9CA10,0,2,2,1,0,0,0.126819,0
311,7CDDA234,0,1,1,1,0,0,0.005185,0
312,7BF6B3A2,3,2,5,0.555556,4,0.000007,0.000004,0.024082
313,80E699E4,1,0,1,0,0,0,0,0.005831
314,77FBC406,0,1,1,1,0,0,0,0
315,7C13A0AD,0,2,2,1,0,0,0.008185,0
316,8078FE2D,0,1,1,1,0,0,0,0
317,59F59044,1,2,3,0.666667,6,0,0,0.019007
318,77502702,0,1,1,0.571429,0,0,0.024823,0
319,7FCEDD1A,0,1,1,0.416667,0,0,0,0
320,7F0C6667,0,1,1,1,0,0,0.000065,0
321,5BF82CE3,2,0,2,0,0,0.000214,0,0.045372
322,7C791BF9,0,1,1,1,0,0,0,0
323,5C3103B0,1,0,1,0,0,0,0,0.005831
324,60A90300,0,2,2,0.75,0,0,0,0
325,753568E5,0,1,1,0.317073,0,0,0,0
326,7EC3FFCB,0,3,3,1,0,0,0.000103,0
327,801E5BB1,0,1,1,1,0,0,0,0
328,7AA53B3B,3,0,3,0,0,0.000187,0,0.017494
329,80CA6543,0,3,3,0.8,0,0,0,0
330,80D392C6,31,3,34,1,198.5,0.180631,0.060364,0.527923
331,6C0298A4,0,1,1,1,0,0,0.005172,0
332,75AED858,0,4,4,0.833333,0,0,0,0
333,7E73AF26,0,2,2,0.75,0,0,0.02258,0
334,801D8FCE,0,1,1,1,0,0,0.005219,0
335,77B6CE73,0,1,1,1,0,0,0,0
336,7A78D8D0,0,1,1,1,0,0,0,0
337,81797A1A,0,1,1,1,0,0,0.002937,0
338,62467AA5,2,0,2,0,0,0.000026,0,0.035105
339,5A25EF93,0,2,2,1,0,0,0,0
340,76F90626,3,4,7,0.37931,112.5,0.002788,0.00181,0.017494
341,80724366,1,1,2,1,0,0.015794,0.11276,0.005831
342,6E0983D7,0,1,1,1,0,0,0.000107,0
343,769E77A4,0,1,1,0.454545,0,0,0,0
344,61AAB9D7,0,1,1,1,0,0,0,0
345,7D67E9FF,2,0,2,0,0,0,0,0.024839
346,5D1FD91C,0,2,2,0.75,0,0,0,0
347,7B40CA29,0,2,2,1,0,0,0.014402,0
348,7631698E,3,4,7,0.7,21,0.000329,0.014461,0.017494
349,63E66364,2,0,2,0,0,0.001335,0,0.011663
350,7F868FF4,2,1,3,1,2,0.020005,0.009483,0.024839
351,75098F83,0,1,1,1,0,0,0,0
352,766D1A0F,0,2,2,0.424242,0,0,0.000003,0
353,76589AE4,0,2,2,0.75,0,0,0,0
354,053C7747,4,0,4,0,0,0.006441,0,0.128961
355,8056E553,0,2,2,0.354839,0,0,0.026753,0
356,62C5EBB5,7,0,7,0,0,0,0,0.067171
357,7C4FB549,1,0,1,0,0,0.001354,0,0.005831
358,7E7808BF,12,3,15,0.714286,68.833333,0.117341,0.127142,0.140303
359,7DB7B57D,0,1,1,1,0,0,0.006654,0
360,76279AB5,0,2,2,0.666667,0,0,0.000043,0
361,76BB2CB2,0,2,2,0.5625,0,0,0.004764,0
362,5C165CA1,3,1,4,0.491803,58,0.014047,0.007641,0.017494
363,6DCAAFDC,1,1,2,0.5,0,0.000801,0.00163,0.005831
364,5BF8772A,0,1,1,0.666667,0,0,0.00586,0
365,8076B530,0,1,1,1,0,0,0,0
366,5A0CA622,1,1,2,0.40625,0,0,0.000003,0.005831
367,7929D24B,1,0,1,0,0,0,0,0.005831
368,7AF1AC8A,0,2,2,0.75,0,0,0,0
369,7B3E91A4,0,1,1,1,0,0,0.01406,0
370,7AD89D1E,1,0,1,0,0,0,0,0.005831
371,7F908BB3,0,1,1,0.5,0,0,0.00163,0
372,79017D7E,0,2,2,0.75,0,0,0,0
373,5DFE89CF,26,0,26,0,0,0.059327,0,0.394767
374,7EE48A59,7,1,8,1,7,0,0.008153,0.040819
375,815AA738,2,0,2,0,0,0.003711,0,0.011663
376,80278E61,2,1,3,1,1,0,0,0.011663
377,5A2E373A,1,0,1,0,0,0,0,0.005831
378,817A2BCE,2,3,5,0.444444,6,0,0,0.018251
379,8009F1AE,8,0,8,0,0,0.013747,0,0.185139
380,78FFF7F3,1,0,1,0,0,0,0,0.005831
381,7DB4BB80,0,1,1,1,0,0,0.001181,0
382,79A7221F,1,3,4,0.8,4,0,0.0133,0.005831
383,7BF821E4,0,1,1,0.666667,0,0,0.009795,0
384,788F8779,8,0,8,0,0,0.021596,0,0.197615
385,7E55664F,4,0,4,0,0,0.018805,0,0.049677
386,8044DD47,0,2,2,1,0,0,0,0
387,7D459119,3,0,3,0,0,0.035821,0,0.047524
388,8071ADD8,0,1,1,1,0,0,0,0
389,6FC32C79,12,5,17,0.28777,420.833333,0.00653,0.002307,0.124801
390,7A584785,0,1,1,0.666667,0,0,0,0
391,800880E9,2,0,2,0,0,0.000276,0,0.011663
392,750F4E68,7,0,7,0,0,0.019181,0,0.482032
393,7A4E6427,0,1,1,1,0,0,0.11276,0
394,782D74BE,0,1,1,0.416667,0,0,0,0
395,7A03FD14,2,0,2,0,0,0.00019,0,0.018251
396,7C78AFF2,0,1,1,1,0,0,0.01406,0
397,7A212B9A,2,0,2,0,0,0.000238,0,0.011663
398,8146B364,0,1,1,0.666667,0,0,0.000124,0
399,5D43D998,0,1,1,0.461538,0,0,0.000001,0
400,80E79EFE,0,1,1,1,0,0,0,0
401,060A5BF0,0,1,1,1,0,0,0.001042,0
402,5EEE13F2,0,4,4,0.833333,0,0,0,0
403,80DFDDF3,3,4,7,0.515625,687.666667,0.000725,0.067035,0.143021
404,5C53D253,1,2,3,0.75,0,0,0.000003,0.022686
405,080A7D49,5,0,5,0,0,0.006604,0,0.414489
406,7B626573,1,1,2,0.666667,2,0.000746,0.000445,0.005831
407,602C796A,0,1,1,1,0,0,0.001212,0
408,79209CD6,1,5,6,0.631579,10,0.001399,0.03215,0.005831
409,7EED334B,1,0,1,0,0,0,0,0.005831
410,76B55918,0,1,1,0.428571,0,0,0.006238,0
411,80AB6030,1,0,1,0,0,0.001399,0,0.005831
412,76D89B1B,0,1,1,1,0,0,0,0
413,760DAC0A,0,1,1,1,0,0,0.0001,0
414,76DFCED7,1,2,3,0.232044,3,0.000126,0.001254,0.016098
415,8066DEFC,1,0,1,0,0,0,0,0.005831
416,799775D5,0,1,1,1,0,0,0,0
417,59FBC9BF,0,1,1,1,0,0,0.000001,0
418,7B9B9591,2,0,2,0,0,0.000131,0,0.018251
419,776A5AEE,0,2,2,0.428571,0,0,0.003723,0
420,5CCD86EA,0,1,1,1,0,0,0,0
421,5E9CDB60,0,1,1,1,0,0,0.0001,0
422,7D7BFB47,0,3,3,1,0,0,0.008934,0
423,5D6B01DC,1,1,2,1,0,0.000128,0.000018,0.005831
424,7FF31C27,0,2,2,0.5,0,0,0.019506,0
425,7EEA5CE1,2,0,2,0,0,0.000208,0,0.018251
426,7794D544,0,1,1,1,0,0,0.002056,0
427,80CB9AEC,0,1,1,1,0,0,0.11276,0
428,769D2945,10,0,10,0,0,0.065039,0,0.848133
429,7F7FE042,6,2,8,0.75,13.5,0.085286,0.001088,0.041576
430,7E95E7AD,1,0,1,0,0,0,0,0.005831
431,79F0B555,3,0,3,0,0,0,0,0.040936
432,7E90E578,0,1,1,1,0,0,0.000026,0
433,5E370059,1,3,4,0.470588,0.5,0.000801,0.000988,0.005831
434,7E225779,2,0,2,0,0,0.004793,0,0.044603
435,80B95072,0,1,1,1,0,0,0,0
436,75FD0F67,1,1,2,1,1,0,0,0.005831
437,75881784,0,2,2,1,0,0,0,0
438,8114BECE,0,3,3,0.8,0,0,0.031763,0
439,7CCFC576,0,2,2,0.75,0,0,0.055173,0
440,811F38EA,3,1,4,1,2.5,0.025306,0.000044,0.017494
441,5B923D67,0,4,4,0.75,0,0,0.018967,0
442,5A73690B,2,4,6,0.526316,1.5,0.001677,0.009386,0.011663
443,7D851D6C,0,2,2,1,0,0,0.054111,0
444,72719B81,3,0,3,0,0,0.003573,0,0.074645
445,7EE4A169,1,0,1,0,0,0,0,0.005831
446,5DC01A3F,0,1,1,1,0,0,0.001212,0
447,75C3ED49,0,1,1,1,0,0,0.000845,0
448,7A1B7F43,0,1,1,1,0,0,0.000021,0
449,7F5E9A4A,0,1,1,0.666667,0,0,0,0
450,7AB3BCE9,1,0,1,0,0,0,0,0.005831
451,7F436724,2,0,2,0,0,0.004524,0,0.011663
452,80BE72B4,1,0,1,0,0,0,0,0.005831
453,7E38FA8C,0,1,1,1,0,0,0,0
454,79CD7C67,0,5,5,0.727273,0,0,0.034838,0
455,7C471851,0,1,1,0.533333,0,0,0.004674,0
456,7E522838,1,0,1,0,0,0.000655,0,0.005831
457,5C5AF7FD,0,1,1,1,0,0,0.005219,0
458,7673D9C3,0,1,1,1,0,0,0.000004,0
459,5F1BA789,0,2,2,0.344086,0,0,0.001968,0
460,7AD65442,0,1,1,0.666667,0,0,0,0
461,7B827728,0,1,1,0.5,0,0,0.00163,0
462,5ADDE998,2,0,2,0,0,0.000208,0,0.018251
463,782012A1,0,3,3,0.292994,0,0,0.001306,0
464,78369BC8,5,0,5,0,0,0.019938,0,0.082629
465,7A62849E,0,1,1,0.491803,0,0,0.007641,0
466,7C91966B,0,1,1,1,0,0,0,0
467,77531D91,0,1,1,1,0,0,0,0
468,5FF82AD7,3,1,4,1,5,0.00027,0,0.03067
469,80B99314,0,1,1,1,0,0,0,0
470,75E66A87,3,9,12,0.65,25.5,0.0246,0.189884,0.017494
471,7B742528,0,2,2,1,0,0,0.005482,0
472,087D6289,1,0,1,0,0,0,0,0.005831
473,7D86CD58,1,0,1,0,0,0,0,0.005831
474,78D64BE5,0,1,1,1,0,0,0.11276,0
475,7F0CF03D,0,1,1,0.5,0,0,0.002546,0
476,7E53AC45,11,3,14,0.588235,123.666667,0.077171,0.016359,0.171822
477,7C2235A1,1,0,1,0,0,0.005173,0,0.10488
478,77C76681,2,0,2,0,0,0,0,0.011663
479,76E32E9C,0,1,1,1,0,0,0.002968,0
480,7BFBCB5B,0,1,1,0.666667,0,0,0.001099,0
481,75B543E9,1,1,2,0.666667,0,0.003048,0.021758,0.005831
482,7CF4EFFB,0,2,2,1,0,0,0.165849,0
483,5D4F81AE,0,1,1,1,0,0,0.000033,0
484,7ABDCCD6,0,1,1,0.5,0,0,0.000497,0
485,5BF53C73,4,1,5,1,4,0.003239,0.008153,0.036501
486,77DC8244,0,2,2,0.454545,0,0,0.002776,0
487,76ABA68C,1,1,2,1,1,0.002422,0.000019,0.005831
488,7582CDAA,1,0,1,0,0,0,0,0.005831
489,77FA609C,0,4,4,1,0,0,0.005547,0
490,7C4AD466,0,1,1,1,0,0,0,0
491,768C5385,1,0,1,0,0,0.00183,0,0.005831
492,7C6A47C9,7,2,9,0.75,16,0,0,0.084025
493,7EA330FD,4,3,7,0.571429,20.833333,0.070348,0.047679,0.043089
494,7C4E63B0,2,2,4,1,8,0,0.01433,0.024839
495,000ACAC5,1,0,1,0,0,0.000726,0,0.070314
496,7E6879D0,0,1,1,0.491803,0,0,0.007641,0
497,80086AB6,1,0,1,0,0,0,0,0.005831
498,8051CE46,0,1,1,0.533333,0,0,0.004674,0
499,7E8724EA,1,5,6,0.256983,11,0.000166,0.006185,0.005831
500,7587FFB9,0,2,2,0.466667,0,0,0.118998,0
501,773A262E,0,2,2,0.666667,0,0,0.126402,0
502,7FB36959,5,2,7,1,5.5,0.026334,0.061242,0.035744
503,5972D6B9,3,0,3,0,0,0.017067,0,0.03067
504,5B3F0056,0,2,2,0.666667,0,0,0.008492,0
505,5873F73B,1,2,3,0.75,3,0,0.001482,0.005831
506,7EBC642E,0,2,2,0.4375,0,0,0.014695,0
507,7812A901,2,0,2,0,0,0.002594,0,0.023282
508,801DF3D6,1,1,2,1,0,0.000187,0.000026,0.005831
509,801103D8,0,3,3,0.714286,0,0,0.082842,0
510,7FDED6D6,1,0,1,0,0,0,0,0.005831
511,679DDAFA,2,0,2,0,0,0,0,0.011663
512,7AE6BD37,1,0,1,0,0,0,0,0.005831
513,6A1B7A68,9,27,36,0.935484,932,0.055601,0.037639,0.147198
514,5EB56273,0,1,1,1,0,0,0.01406,0
515,80B879CA,3,0,3,0,0,0,0,0.03067
516,7A059493,3,6,9,0.8,10.083333,0.024269,0.079504,0.024082
517,765A80FF,0,4,4,0.588235,0,0,0.061337,0
518,6CA2C916,2,0,2,0,0,0,0,0.011663
519,7DD16641,1,0,1,0,0,0.001065,0,0.046128
520,752DA09E,5,0,5,0,0,0.014958,0,0.514785
521,7694448D,4,2,6,1,11,0.008577,0.005285,0.104651
522,8027B02B,1,1,2,1,20,0.000217,0.01406,0.111595
523,7F17C7C2,1,0,1,0,0,0,0,0.012419
524,7D3AD997,0,3,3,0.625,0,0,0.005428,0
525,7577FD1D,0,4,4,1,0,0,0.006401,0
526,7E4DD1BC,0,1,1,0.666667,0,0,0.000029,0
527,5C736746,0,1,1,1,0,0,0.001212,0
528,7655C9CA,0,1,1,1,0,0,0,0
529,7A92CC7D,0,2,2,0.666667,0,0,0.000043,0
530,7E8F0CBC,2,2,4,0.75,29.5,0.03962,0.0354,0.127885
531,2417C4DB,0,1,1,1,0,0,0,0
532,7D24F0D3,1,0,1,0,0,0.001987,0,0.025595
533,78AAEDCF,2,2,4,1,1.5,0.007851,0.017788,0.050403
534,7DBE91C8,0,1,1,1,0,0,0.053089,0
535,58A77790,1,0,1,0,0,0.000762,0,0.005831
536,80DBF875,1,1,2,0.6,3,0,0.000042,0.005831
537,7C68D222,0,1,1,1,0,0,0,0
538,7D0CBE57,1,0,1,0,0,0.003581,0,0.012419
539,05A1EB6D,1,0,1,0,0,0,0,0.005831
540,7F7F4388,0,8,8,0.517241,0,0,0.155782,0
541,80417ADA,0,1,1,1,0,0,0.11276,0
542,782EAD13,1,0,1,0,0,0.000847,0,0.058052
543,7A497D83,0,3,3,0.529412,0,0,0.022489,0
544,79D3E945,0,1,1,0.461538,0,0,0,0
545,797D81BD,1,0,1,0,0,0.000727,0,0.005831
546,7D6C0598,0,1,1,1,0,0,0,0
547,7FF13771,6,2,8,0.625,32,0.045393,0.038882,0.06714
548,593D100F,2,0,2,0,0,0.000668,0,0.011663
549,80F92B97,1,1,2,1,0,0.00088,0.005172,0.005831
550,7D16E87F,0,3,3,1,0,0,0.013572,0
551,76C30F89,0,1,1,1,0,0,0,0
552,75C804BD,3,2,5,0.6,32,0.016433,0.031061,0.040936
553,06C8225C,1,0,1,0,0,0,0,0.005831
554,75487C02,3,0,3,0,0,0.002253,0,0.024082
555,7CC62C76,0,1,1,1,0,0,0.11276,0
556,5E366623,0,1,1,0.666667,0,0,0,0
557,7B656940,0,1,1,0.6,0,0,0.013642,0
558,7B19B92F,0,2,2,0.625,0,0,0.004077,0
559,7DB312C0,0,1,1,1,0,0,0,0
560,76F5FA6A,1,0,1,0,0,0,0,0.052716
561,0BD5F0D8,4,0,4,0,0,0.010005,0,0.311922
562,7EE67123,1,0,1,0,0,0.002098,0,0.036028
563,7DADD024,0,1,1,1,0,0,0,0
564,7F375BDA,0,1,1,1,0,0,0.000288,0
565,7856FBD3,1,0,1,0,0,0.005173,0,0.10488
566,7B93A387,1,0,1,0,0,0,0,0.005831
567,7E7B8D13,0,1,1,0.571429,0,0,0.024823,0
568,7BBC366E,1,1,2,1,1,0,0,0.005831
569,75494C3C,3,1,4,1,3,0.00005,0,0.024082
570,77F565AE,1,0,1,0,0,0,0,0.005831
571,7F6DC727,1,1,2,1,1,0,0,0.005831
572,7D86B8F8,1,0,1,0,0,0.007436,0,0.005831
573,7FC08B62,1,0,1,0,0,0,0,0.005831
574,75DA9FB2,3,1,4,1,0.333333,0.035474,0.00274,0.03067
575,7E224045,1,0,1,0,0,0.001065,0,0.046128
576,5CA100E8,1,2,3,0.571429,4,0.001393,0,0.005831
577,6D0ADD57,0,3,3,0.6,0,0,0.000005,0
578,5E9A6F66,0,1,1,1,0,0,0.053089,0
579,7CA115F9,0,1,1,1,0,0,0,0
580,7F627B23,0,1,1,0.416667,0,0,0.000932,0
581,7CD0B11E,2,0,2,0,0,0,0,0.011663
582,7A7576F0,0,1,1,1,0,0,0.000001,0
583,78C48629,0,1,1,1,0,0,0.000026,0
584,7BE7AEE9,1,1,2,1,1,0,0,0.005831
585,7DDF1F6D,0,2,2,1,0,0,0,0
586,790A6AD7,2,1,3,1,2,0,0,0.018251
587,0240BBC0,2,0,2,0,0,0.000001,0,0.087919
588,5E5ADE23,0,1,1,1,0,0,0,0
589,76202CAC,0,1,1,0.6,0,0,0.013642,0
590,700AE809,2,0,2,0,0,0,0,0.024839
591,7D9353F7,0,1,1,0.40625,0,0,0.000003,0
592,7BD3B9AB,0,2,2,0.75,0,0,0.000037,0
593,7739D71D,0,3,3,0.8,0,0,0.016329,0
594,755952C3,0,1,1,0.666667,0,0,0,0
595,7D139C2C,0,2,2,0.454545,0,0,0.001481,0
596,5DE1E502,1,0,1,0,0,0.001296,0,0.005831
597,7E895C5F,0,1,1,1,0,0,0.005172,0
598,79FEF31D,5,0,5,0,0,0.005426,0,0.035744
599,7FBCBA03,2,0,2,0,0,0,0,0.018251
600,7904EEAB,0,2,2,0.45,0,0,0.002954,0
601,7B3BBF3A,1,5,6,0.666667,6,0.019405,0.132273,0.005831
602,79D4D0E4,0,1,1,1,0,0,0,0
603,7652A3F3,0,1,1,0.666667,0,0,0.00885,0
604,8167B992,1,3,4,0.8,1,0.021408,0.02661,0.005831
605,7AEDDEA6,2,0,2,0,0,0.011784,0,0.011663
606,7F108404,0,1,1,0.666667,0,0,0.00586,0
607,77210889,1,0,1,0,0,0.017228,0,0.019007
608,7CE913CA,0,5,5,0.301887,0,0,0.001358,0
609,7924E2C7,1,0,1,0,0,0,0,0.005831
610,789240F8,0,1,1,0.571429,0,0,0.024823,0
611,75250ABC,0,4,4,1,0,0,0,0
612,7E02C025,1,0,1,0,0,0,0,0.005831
613,7C121ED8,10,1,11,1,23.166667,0.07128,0.001496,0.284149
614,7910E150,0,1,1,1,0,0,0.000002,0
615,5F2BAD7A,0,2,2,0.75,0,0,0.00532,0
616,7FFD7E7C,0,2,2,1,0,0,0,0
617,7D4B2F93,0,1,1,1,0,0,0.000845,0
618,75C68519,1,0,1,0,0,0.004439,0,0.005831
619,76F8A2E1,0,2,2,1,0,0,0.008598,0
620,7708C25C,0,1,1,1,0,0,0,0
621,80839269,1,0,1,0,0,0,0,0.005831
622,8145682F,3,3,6,0.8,23,0,0.015269,0.03938
623,7FC75423,0,4,4,0.7,0,0,0.155721,0
624,781B0627,1,0,1,0,0,0,0,0.005831
625,7971FC0B,2,7,9,0.488889,29,0.011687,0.244083,0.011663
626,7A7F1A7D,2,1,3,1,2.666667,0.004957,0.053089,0.031427
627,7DDCEAA2,0,3,3,0.271845,0,0,0.001209,0
628,797F61C3,0,1,1,1,0,0,0.000746,0
629,7C8715E1,1,0,1,0,0,0.004702,0,0.019007
630,7C6832CD,1,1,2,1,0,0.000369,0.002584,0.005831
631,756E0A0A,0,2,2,1,0,0,0,0
632,7B2872AE,0,1,1,1,0,0,0.11276,0
633,7D7DCFEB,5,0,5,0,0,0.007011,0,0.110482
634,6A4BCB3D,0,1,1,1,0,0,0,0
635,78687CB9,0,1,1,0.461538,0,0,0.016125,0
636,78F9553F,2,7,9,0.316901,82.5,0.008445,0.034219,0.011663
637,7D15B2F1,0,1,1,1,0,0,0,0
638,7C5BEDDF,1,0,1,0,0,0,0,0.005831
639,75502685,0,2,2,0.5,0,0,0.016436,0
640,59F27421,1,0,1,0,0,0,0,0.005831
641,7B417486,0,3,3,0.178571,0,0,0.000007,0
642,7A174700,0,4,4,1,0,0,0.005293,0
643,75321FEA,1,0,1,0,0,0.018177,0,0.012419
644,7B2A2624,0,1,1,1,0,0,0.11276,0
645,767DB79E,1,0,1,0,0,0,0,0.005831
646,7D3B64E1,0,1,1,0.571429,0,0,0.024823,0
647,7E38F8DE,0,1,1,1,0,0,0.002056,0
648,797733FE,0,1,1,1,0,0,0.001496,0
649,7A3C1F6A,2,0,2,0,0,0.007582,0,0.011663
650,7EF42D0F,0,5,5,0.5,0,0,0,0
651,78E2C03E,6,4,10,1,25.5,0.011079,0.013782,0.054752
652,5BFB2CCC,1,0,1,0,0,0,0,0.012419
653,5F697B67,0,2,2,0.75,0,0,0.058949,0
654,5F9B7048,1,1,2,0.666667,0,0,0,0.005831
655,08749267,1,0,1,0,0,0.000003,0,0.043219
656,7AC54865,0,2,2,0.625,0,0,0.00666,0
657,7EDE01B2,1,2,3,1,0,0,0,0.005831
658,7D81D04F,3,0,3,0,0,0.00213,0,0.066667
659,80DBF8C6,0,1,1,1,0,0,0,0
660,8109D714,0,1,1,1,0,0,0,0
661,7714050A,0,1,1,0.666667,0,0,0.00586,0
662,5A53DC10,1,1,2,1,0,0.001296,0.008153,0.005831
663,80359DCE,0,2,2,0.393939,0,0,0.001661,0
664,6D9D2BCA,0,1,1,0.666667,0,0,0.000231,0
665,7683DF85,3,4,7,0.457143,7,0.003949,0.01304,0.062822
666,776180A5,0,1,1,1,0,0,0,0
667,7C66892E,12,3,15,1,52.5,0.010484,0.003517,0.607532
668,5D9B75D7,0,5,5,0.55,0,0,0.009616,0
669,7AA3D69F,1,3,4,0.478261,8,0.000228,0.001484,0.005831
670,7A79F4FD,0,1,1,0.32,0,0,0.003375,0
671,7D6C29AA,0,2,2,0.473684,0,0,0.000046,0
672,7E728705,0,2,2,0.75,0,0,0,0
673,7BB98473,6,1,7,1,16,0,0,0.128739
674,7F49E5BB,1,0,1,0,0,0.001103,0,0.005831
675,5A5C90DC,0,1,1,1,0,0,0,0
676,7D9F6510,0,2,2,0.75,0,0,0.055173,0
677,7CC1637B,1,0,1,0,0,0.007846,0,0.005831
678,7F8399B4,15,2,17,1,28.833333,0.099269,0.030696,0.215224
679,7DA5BB86,0,3,3,1,0,0,0.002686,0
680,7B069868,0,2,2,0.466667,0,0,0.118753,0
681,7629C196,1,0,1,0,0,0,0,0.005831
682,7E92BF8B,0,1,1,1,0,0,0.001212,0
683,7DE3D027,1,1,2,1,1,0.000005,0,0.005831
684,7A10D5B1,0,1,1,1,0,0,0.000096,0
685,80D8FF0C,0,1,1,1,0,0,0,0
686,7CA54E07,0,1,1,1,0,0,0.01406,0
687,7A9055F5,0,1,1,1,0,0,0.01406,0
688,7F3D96EC,5,2,7,1,14,0.000007,0.000002,0.116904
689,7F4EC541,0,1,1,1,0,0,0.001889,0
690,78E303D3,0,1,1,1,0,0,0,0
691,7DCDC5F1,3,0,3,0,0,0.048417,0,0.037258
692,76B4C9C6,0,1,1,0.368421,0,0,0,0
693,7BB9CE27,0,2,2,0.625,0,0,0,0
694,77632AB4,0,7,7,0.317647,0,0,0.017622,0
695,66614CCB,0,1,1,1,0,0,0.000107,0
696,59A615C4,0,1,1,1,0,0,0.001415,0
697,5B79C7AF,6,0,6,0,0,0.00615,0,0.190419
698,7938E606,0,3,3,0.588235,0,0,0.00487,0
699,5CA30F4F,0,2,2,0.407407,0,0,0.002641,0
700,7893B9CF,4,0,4,0,0,0,0,0.053356
701,77C00C50,1,0,1,0,0,0,0,0.005831
702,7D069928,0,1,1,0.416667,0,0,0.000932,0
703,743052D4,2,0,2,0,0,0,0,0.018251
704,80DCAAC2,0,3,3,0.25,0,0,0.060242,0
705,7DA028E8,0,1,1,1,0,0,0,0
706,778FF174,3,0,3,0,0,0,0,0.03067
707,7714993F,0,2,2,1,0,0,0.008028,0
708,7EAD4110,24,7,31,1,314.833333,0.034015,0.008685,0.437548
709,80055A7A,10,1,11,1,48.5,0.010575,0.001057,0.433378
710,619947F4,1,1,2,1,0,0.001142,0.008153,0.005831
711,7B82320F,1,0,1,0,0,0,0,0.005831
712,794AFA29,0,1,1,1,0,0,0,0
713,80B8F577,0,2,2,0.413793,0,0,0.006628,0
714,780901E3,2,1,3,0.666667,4,0.003615,0.001828,0.011663
715,7E1558B9,0,1,1,1,0,0,0.005172,0
716,754FA369,1,0,1,0,0,0.026094,0,0.025595
717,81751AA4,1,0,1,0,0,0,0,0.005831
718,7A080F7A,0,1,1,1,0,0,0,0
719,7780A9DE,3,2,5,0.75,5,0.011391,0.000184,0.024082
720,58D2377F,1,1,2,1,0,0,0,0.005831
721,77BC4E7F,0,2,2,1,0,0,0.114981,0
722,5D9952A5,8,0,8,0,0,0.035458,0,0.11039
723,812FADA1,11,0,11,0,0,0.057314,0,0.116848
724,76E8ADB0,1,0,1,0,0,0,0,0.012419
725,780F7169,0,3,3,0.47619,0,0,0.004167,0
726,7B726760,1,0,1,0,0,0.000014,0,0.005831
727,815060A9,0,2,2,0.239362,0,0,0.012618,0
728,79699889,2,2,4,0.5,12,0,0.128885,0.011663
729,7660F5E3,0,1,1,0.428571,0,0,0.001146,0
730,7EA12692,0,1,1,1,0,0,0.000725,0
731,7EBC7994,1,1,2,1,1,0,0,0.019776
732,792859ED,1,1,2,1,1,0,0.009483,0.005831
733,7D48C6E2,0,1,1,1,0,0,0.000029,0
734,755E5D21,0,1,1,1,0,0,0.000026,0
735,592C1B59,0,1,1,1,0,0,0,0
736,59499344,0,1,1,1,0,0,0,0
737,7C2C1D39,0,3,3,0.289655,0,0,0.001701,0
738,0B189AEB,1,0,1,0,0,0,0,0.005831
739,7D67FCB7,0,3,3,0.46875,0,0,0.004858,0
740,587E54BA,1,0,1,0,0,0,0,0.005831
741,5CCC46F4,3,0,3,0,0,0,0,0.017494
742,7840B6A9,0,1,1,1,0,0,0.11276,0
743,785AC0D4,2,1,3,1,2,0.015164,0,0.011663
744,7E9032A4,2,4,6,0.7,14,0,0.001529,0.011663
745,5C733ABD,4,2,6,1,14,0.000306,0.000022,0.043089
746,5EEA988D,2,3,5,0.8,8,0.000001,0.000003,0.018251
747,7EEA510E,1,6,7,0.727273,0,0,0,0.005831
748,5F4CE14B,3,0,3,0,0,0.004459,0,0.017494
749,815A4E9B,0,2,2,1,0,0,0.015117,0
750,7EE04AC2,1,0,1,0,0,0,0,0.005831
751,78AACF4C,0,7,7,0.528571,0,0,0.073496,0
752,7BB096BB,0,1,1,0.428571,0,0,0,0
753,7E866AF1,1,0,1,0,0,0,0,0.005831
754,7DA5460F,1,1,2,1,0,0.000006,0.000002,0.005831
755,7DBC9607,0,1,1,1,0,0,0.11276,0
756,8008E43A,0,1,1,0.666667,0,0,0.00586,0
757,75225A15,0,4,4,0.521739,0,0,0.141206,0
758,7BD843FF,0,1,1,0.533333,0,0,0.004674,0
759,5FB82FDA,3,2,5,1,4.5,0.002734,0.008187,0.034348
760,059F0EDA,0,1,1,0.666667,0,0,0,0
761,7EC0370B,2,1,3,1,1,0.002523,0.007876,0.011663
762,7EA1EB54,0,2,2,1,0,0,0.008511,0
763,80CF94DE,1,0,1,0,0,0,0,0.005831
764,80A219C9,0,1,1,1,0,0,0.01406,0
765,752F2199,0,1,1,1,0,0,0,0
766,7812143C,0,2,2,1,0,0,0.114973,0
767,809CADCA,3,2,5,0.555556,6,0.001382,0.001793,0.03067
768,7A3077B0,0,1,1,0.666667,0,0,0,0
769,7EA9AC08,0,1,1,0.5,0,0,0.00163,0
770,5DB60EDA,1,0,1,0,0,0,0,0.005831
771,7D8270FA,1,1,2,1,1,0,0.11276,0.005831
772,80B34684,1,1,2,0.6,1,0.000006,0.000001,0.005831
773,751235FF,1,1,2,0.461538,0,0.002259,0.016125,0.005831
774,7D330154,0,5,5,0.55,0,0,0.011808,0
775,79151983,0,1,1,1,0,0,0.01406,0
776,75D2AFE2,0,8,8,0.681818,0,0,0.047204,0
777,7A04C044,0,2,2,1,0,0,0.054131,0
778,75886846,4,0,4,0,0,0,0,0.068654
779,810EE9CF,1,2,3,0.666667,0.666667,0.004702,0.077912,0.019007
780,7EC4B130,2,3,5,0.583333,15,0,0,0.028517
781,7B1AEF5B,2,2,4,1,0,0.000008,0.000002,0.028517
782,072085CF,2,0,2,0,0,0.000005,0,0.024839
783,5D26A0B9,0,1,1,1,0,0,0.053089,0
784,81028C03,0,1,1,1,0,0,0,0
785,7DED9EB3,2,0,2,0,0,0.000534,0,0.225307
786,76D6A668,1,0,1,0,0,0.000001,0,0.005831
787,79BCE1C3,0,1,1,0.5,0,0,0,0
788,7AFE440C,0,1,1,1,0,0,0.000019,0
789,7766EBB6,4,0,4,0,0,0.021368,0,0.029913
790,7DAB26DD,1,0,1,0,0,0,0,0.005831
791,7521495D,3,1,4,0.411765,17,0.024557,0.002258,0.024082
792,81052765,0,1,1,1,0,0,0.001889,0
793,7E4B4E43,0,2,2,0.5625,0,0,0.004858,0
794,5A0E856D,0,1,1,1,0,0,0,0
795,5E0EFEBA,1,0,1,0,0,0.000206,0,0.005831
796,092B87BF,2,0,2,0,0,0.016104,0,0.011663
797,6EAE78F7,1,0,1,0,0,0.000801,0,0.005831
798,75404C8A,1,7,8,1,5.333333,0.000259,0.080569,0.005831
799,7F90A0DC,0,3,3,0.48,0,0,0,0
800,7E3028E1,4,0,4,0,0,0.011526,0,0.036501
801,8003FB71,0,2,2,0.555556,0,0,0,0
802,085FB010,2,3,5,0.714286,10,0.000005,0.002099,0.011663
803,7B580BE8,1,0,1,0,0,0,0,0.005831
804,7817BD08,0,2,2,0.416667,0,0,0.009854,0
805,7901DF72,0,2,2,1,0,0,0.007075,0
806,07C89F77,0,2,2,0.625,0,0,0.025301,0
807,7CAF209D,2,0,2,0,0,0.010294,0,0.011663
808,80729098,2,0,2,0,0,0,0,0.011663
809,5FBFA1D7,0,3,3,1,0,0,0,0
810,0B2EA2E1,0,3,3,0.636364,0,0,0.028989,0
811,79525CEA,4,2,6,0.666667,12,0.000013,0.000002,0.053356
812,6BAB5329,0,7,7,0.75,0,0,0,0
813,7D762E5E,0,3,3,0.451613,0,0,0.01018,0
814,7FBAD9E4,4,2,6,1,14,0.000307,0.005309,0.043089
815,793D1F3B,1,3,4,1,34,0.005173,0.006163,0.10488
816,58DC2B3C,0,2,2,1,0,0,0,0
817,5E450025,0,3,3,0.8,0,0,0,0
818,76438064,1,4,5,0.588235,0.5,0.000801,0.003566,0.005831
819,5A42FEC9,0,2,2,1,0,0,0,0
820,09C4B886,3,0,3,0,0,0.001183,0,0.051203
821,7A8DD8E1,1,2,3,0.625,0.5,0.000282,0.009675,0.005831
822,815D56B0,0,1,1,0.444444,0,0,0,0
823,76BF5914,0,2,2,0.625,0,0,0.009592,0
824,78D002D4,0,1,1,1,0,0,0.000096,0
825,7B81695C,0,1,1,1,0,0,0.002312,0
826,5CCA92FB,0,2,2,0.75,0,0,0,0
827,7D798E6F,1,0,1,0,0,0,0,0.005831
828,7FC5CFF8,0,1,1,0.5,0,0,0,0
829,80F6F135,1,4,5,0.666667,4,0.000801,0.021263,0.005831
830,06121BDB,1,0,1,0,0,0.000006,0,0.005831
831,80493A93,0,1,1,0.428571,0,0,0.006238,0
832,79A697FB,0,1,1,1,0,0,0,0
833,7968BCC9,0,3,3,0.555556,0,0,0.025807,0
834,5C4F99C0,0,1,1,0.666667,0,0,0.001453,0
835,75D49B50,1,1,2,1,1,0,0.001072,0.005831
836,8051B076,0,5,5,1,0,0,0.009432,0
837,7ABB5B97,0,2,2,1,0,0,0.005965,0
838,78ECCA32,2,0,2,0,0,0.005272,0,0.110711
839,0495593F,1,0,1,0,0,0,0,0.005831
840,77D1DAF8,0,3,3,0.8,0,0,0.008274,0
841,7C5815C8,0,1,1,0.428571,0,0,0.001146,0
842,7F84DEBC,0,3,3,0.433962,0,0,0.025853,0
843,7FBDDC98,2,0,2,0,0,0.000815,0,0.038783
844,7D968239,0,2,2,0.75,0,0,0.001863,0
845,7E280521,9,1,10,1,5.5,0.064398,0.008938,0.173335
846,70DF5C1A,1,0,1,0,0,0,0,0.005831
847,78720773,0,1,1,1,0,0,0.053089,0
848,815D263E,0,4,4,1,0,0,0,0
849,80D585BD,1,0,1,0,0,0.001194,0,0.307699
850,796E1EA3,0,1,1,0.571429,0,0,0.024823,0
851,76CB6A7E,0,1,1,1,0,0,0.008153,0
852,7D6525AA,1,0,1,0,0,0.00088,0,0.005831
853,7B9409A7,0,3,3,0.625,0,0,0.014624,0
854,804B3F86,0,2,2,0.5625,0,0,0.004766,0
855,80F40623,9,2,11,0.625,38.5,0.043608,0.026035,0.072245
856,7F0A6C3B,0,1,1,1,0,0,0,0
857,7BE782B5,2,0,2,0,0,0.006019,0,0.162931
858,5E0BAD93,0,2,2,0.508475,0,0,0.012315,0
859,5B1CD62E,1,0,1,0,0,0,0,0.005831
860,5879B357,1,0,1,0,0,0,0,0.005831
861,7C4E703E,0,1,1,0.666667,0,0,0.00586,0
862,7F8770FE,2,0,2,0,0,0.002756,0,0.011663
863,7FDC5E9D,4,0,4,0,0,0,0,0.068654
864,7D655255,0,1,1,1,0,0,0,0
865,7DF548DB,2,1,3,1,1,0.000214,0.000029,0.024839
866,7A44CBB4,0,2,2,0.55,0,0,0.01528,0
867,7B17DD34,0,3,3,0.5,0,0,0.001497,0
868,7A732A1F,1,0,1,0,0,0,0,0.012419
869,77F1C351,1,8,9,0.9,9,0,0.000054,0.005831
870,7F79BB8D,0,1,1,1,0,0,0.11276,0
871,7929A092,0,2,2,0.625,0,0,0.025797,0
872,7DCBECDA,1,0,1,0,0,0,0,0.005831
873,094A81F9,0,1,1,1,0,0,0,0
874,790997B5,0,1,1,0.461538,0,0,0.016125,0
875,78CEE1FA,1,2,3,0.666667,4,0,0.077912,0.005831
876,814D93BB,0,1,1,1,0,0,0,0
877,75FD2021,0,1,1,1,0,0,0.053089,0
878,079F11A0,0,1,1,1,0,0,0,0
879,79E15B8C,1,0,1,0,0,0.000432,0,0.005831
880,7D754747,2,0,2,0,0,0.0078,0,0.024839
881,82704A9B,0,1,1,0.428571,0,0,0.005993,0
882,7928AB5D,0,1,1,0.428571,0,0,0.001146,0
883,78F4F268,0,1,1,1,0,0,0.01406,0
884,7FFE8376,0,2,2,1,0,0,0.067149,0
885,7A2533E8,0,2,2,0.75,0,0,0.022176,0
886,768C5293,1,3,4,0.8,2.333333,0.000259,0.008274,0.005831
887,7AFA8FBA,0,1,1,1,0,0,0,0
888,78E2EC66,2,1,3,1,3,0,0.000908,0.018251
889,80FD6ED9,0,2,2,0.5,0,0,0.117912,0
890,80B725A3,0,2,2,1,0,0,0.007898,0
891,7630B921,1,0,1,0,0,0.000369,0,0.005831
892,7B2B6A78,0,2,2,0.5,0,0,0.06073,0
893,78C76725,0,2,2,0.75,0,0,0.014981,0
894,7FECF49A,0,4,4,0.833333,0,0,0.069418,0
895,76F208B3,0,1,1,1,0,0,0.009483,0
896,5E26543C,5,0,5,0,0,0.007723,0,0.806269
897,76AD7C94,0,3,3,0.8,0,0,0.000123,0
898,811E73E0,1,1,2,1,0,0.001228,0.008153,0.005831
899,7C51731F,0,1,1,1,0,0,0,0
900,7FC30D85,0,1,1,1,0,0,0,0
901,7C5E4912,1,0,1,0,0,0.001859,0,0.005831
902,769D7064,0,1,1,1,0,0,0,0
903,7E366CC2,0,1,1,1,0,0,0.000964,0
904,7E353F0E,1,2,3,0.232044,41,0.001969,0.000916,0.005831
905,85C0A252,0,1,1,1,0,0,0.053089,0
906,7DDDB9E5,0,3,3,0.666667,0,0,0.002052,0
907,5CF96F19,7,0,7,0,0,0.035878,0,0.135535
908,7A72861B,11,1,12,1,9.25,0.042642,0.008938,0.087586
909,7FA9B46B,0,1,1,1,0,0,0.000004,0
910,0920B2C9,1,2,3,0.555556,5,0,0.000002,0.005831
911,7E233BB6,2,5,7,0.5,20.333333,0.018246,0.125365,0.011663
912,5CB38732,1,0,1,0,0,0.005173,0,0.10488
913,7FB00EE2,0,2,2,1,0,0,0,0
914,7DB3D032,2,0,2,0,0,0.000476,0,0.011663
915,7D1284CF,0,2,2,1,0,0,0.007484,0
916,7789F7DD,0,13,13,0.657143,0,0,0.00583,0
917,75542B44,0,1,1,1,0,0,0,0
918,5C47D06A,1,0,1,0,0,0,0,0.005831
919,7763AE21,1,0,1,0,0,0,0,0.005831
920,7509E0F7,1,1,2,0.571429,4,0,0.024823,0.005831
921,7685EDA6,0,1,1,0.5,0,0,0,0
922,7B5C591C,1,2,3,0.75,2,0.001987,0.0354,0.025595
923,5A183636,2,0,2,0,0,0.000005,0,0.024839
924,7F3D0807,1,0,1,0,0,0,0,0.005831
925,817A0BAB,0,1,1,0.666667,0,0,0,0
926,7C759B20,0,2,2,1,0,0,0.11493,0
927,7FBA6946,0,4,4,0.384615,0,0,0.122455,0
928,7869DDA1,0,1,1,0.571429,0,0,0.024823,0
929,7C067E41,0,1,1,1,0,0,0.01406,0
930,7E9683FE,1,0,1,0,0,0.000148,0,0.005831
931,76A6D09F,2,0,2,0,0,0,0,0.011663
932,7E838F3D,1,0,1,0,0,0,0,0.005831
933,7D245BEC,47,0,47,0,0,0.82053,0,0.615766
934,58DB279D,2,0,2,0,0,0,0,0.011663
935,75424E4E,0,1,1,1,0,0,0,0
936,08F4D7C2,1,2,3,0.5625,8,0,0.00986,0.005831
937,7C83BC94,0,5,5,1,0,0,0.013433,0
938,7F81EF29,1,0,1,0,0,0,0,0.005831
939,77306098,7,0,7,0,0,0.069008,0,0.074528
940,7FB6FE61,0,2,2,0.75,0,0,0.005231,0
941,7DA6E964,0,1,1,0.666667,0,0,0.00885,0
942,7BDD3B5F,0,1,1,1,0,0,0,0
943,76F8EA1A,0,4,4,0.75,0,0,0.057094,0
944,5F89D306,1,1,2,1,1,0.000731,0,0.005831
945,77E2D7D6,0,1,1,1,0,0,0,0
946,64397A5F,1,0,1,0,0,0.005173,0,0.10488
947,7A155996,0,2,2,0.5,0,0,0,0
948,8124A06F,0,1,1,1,0,0,0.005185,0
949,782ACC60,3,0,3,0,0,0.000695,0,0.017494
950,04985EF0,0,1,1,0.666667,0,0,0.001828,0
951,78699D71,1,0,1,0,0,0,0,0.012419
952,7E5A97E3,1,2,3,0.75,3,0,0.005231,0.005831
953,7FA08F6C,0,1,1,1,0,0,0,0
954,78A4D2AC,0,1,1,1,0,0,0.000092,0
955,7A777694,0,1,1,0.444444,0,0,0.000045,0
956,755CDA12,2,0,2,0,0,0,0,0.011663
957,7D4111A0,5,2,7,0.555556,17,0.004623,0.002475,0.035744
958,782BF560,1,0,1,0,0,0,0,0.005831
959,7D866902,0,3,3,0.714286,0,0,0.000002,0
960,7F8F5A50,0,1,1,0.571429,0,0,0.001441,0
961,757153C9,8,0,8,0,0,0.010886,0,1
962,7E0FDB5E,8,3,11,0.8,38.5,0.013273,0.003991,0.083834
963,63BEEE84,1,0,1,0,0,0,0,0.091013
964,7BF4CF1C,0,2,2,0.428571,0,0,0.000003,0
965,7DAAB00C,0,1,1,0.571429,0,0,0.001441,0
966,7CD1CE39,0,1,1,1,0,0,0.01406,0
967,7CEE5111,0,2,2,0.5,0,0,0.000038,0
968,7817C07B,1,1,2,1,1,0,0,0.005831
969,7A780E74,1,1,2,1,1,0,0,0.005831
970,7F4719F0,2,7,9,0.714286,14.5,0,0,0.011663
971,7786E5FF,0,1,1,0.666667,0,0,0.021758,0
972,5D0A4B5E,0,1,1,0.666667,0,0,0,0
973,58DC12EC,0,1,1,1,0,0,0,0
974,806ECB0D,3,3,6,0.714286,11.5,0.037492,0.128986,0.017494
975,7D016C02,0,1,1,0.444444,0,0,0,0
976,7C623A5E,2,0,2,0,0,0.00709,0,0.018251
977,80F3630B,0,1,1,1,0,0,0.000026,0
978,7F40C9B0,0,2,2,0.75,0,0,0,0
979,6C1388D3,1,0,1,0,0,0,0,0.005831
980,75087187,1,5,6,0.473684,5,0.000255,0.013593,0.012419
981,7767905F,0,1,1,1,0,0,0.005172,0
982,7D5B187E,0,1,1,1,0,0,0.005172,0
983,7C48A9BC,0,7,7,0.75,0,0,0.000045,0
984,5C57817A,7,0,7,0,0,0.013162,0,0.262899
985,813A90D0,1,0,1,0,0,0,0,0.005831
986,7DBE188B,0,1,1,1,0,0,0.001584,0
987,788C04CC,1,0,1,0,0,0,0,0.005831
988,815AA4AA,0,1,1,0.6,0,0,0.013642,0
989,7D9D45B3,2,0,2,0,0,0.000006,0,0.054082
990,7EDFE617,0,1,1,1,0,0,0.000026,0
991,7D399FE3,1,1,2,1,0.333333,0.016828,0.00274,0.005831
992,80F3FC49,0,1,1,1,0,0,0.000885,0
993,80C0E120,1,0,1,0,0,0,0,0.005831
994,77F73826,0,1,1,1,0,0,0.005219,0
995,7D59E73B,5,1,6,1,7.5,0.007766,0.11276,0.102394
996,74802F94,3,0,3,0,0,0.000271,0,0.024082
997,76CAFFDD,1,2,3,0.234973,86,0.000032,0.000915,0.012419
998,5F196016,0,2,2,1,0,0,0,0
999,7C54724F,1,0,1,0,0,0,0,0.005831
1000,639389BA,0,2,2,0.571429,0,0,0,0
1001,7DD1DB4C,0,2,2,1,0,0,0,0
1002,05A30B05,41,0,41,0,0,0.386319,0,0.848627
1003,5B149866,7,0,7,0,0,0,0,0.060583
1004,7E472F6D,0,1,1,1,0,0,0.11276,0
1005,7D2EF0B7,0,1,1,1,0,0,0,0
1006,7887D583,4,0,4,0,0,0.006981,0,0.748217
1007,76B6ECE4,0,1,1,0.6,0,0,0.013642,0
1008,7EB2415E,0,1,1,1,0,0,0.000746,0
1009,813C3791,0,1,1,1,0,0,0,0
1010,7510F878,0,4,4,0.358974,0,0,0.059188,0
1011,7BF45151,1,0,1,0,0,0,0,0.005831
1012,5DD97DA3,3,1,4,1,1,0,0,0.017494
1013,7FB9D5BF,0,1,1,0.555556,0,0,0.001523,0
1014,7F758794,2,0,2,0,0,0.016164,0,0.011663
